Symbol	Description
A2D1	A2D Funding Plc
A2D2	A2D Funding II Plc
AA	AA Plc
AA07	FTSE Advanced Emerging
AA18	Barclays Bank Plc
AA4	Amedeo Air Four Plus Lim
AAAP	Anglo African Agricultur
AADV	Albion Development Vct Plc
AAEV	Albion Enterprise Vct Plc
AAI	Atlas African Industries Limited
AAIF	Aberdeen Asian Income Fund Ltd
AAL	Anglo American Plc
AAM	Artemis Vct Plc
AAS	Aberdeen Asian Smaller Companies Investm
AASC	Aberdeen Asian Smaller Companies Investm
AASDIGEQ	FTSE Aim Digital Service
AASG	Amundi ETF
AASU	Amundi Investment Solutions
AATG	Albion Technology & General Vct Plc
AAU	Ariana Resources Plc
AAVC	Albion Venture Capital Tst Plc
AAZ	Anglo Asian Mining Plc
ABB1	Santander UK Plc
ABBY	Abbey Plc
ABC	Abcam Plc
ABD	Aberdeen New Dawn Investment Trust Plc
ABDP	Ab Dynamics Plc
ABF	Associated British Foods Plc
ABND	SSGA SPDR ETFS Europe I Plc
ABT	Abbott Laboratories
ABTU	Aqua Bounty Technologies
ABZA	Abzena Plc
AC24	FTSE Japan Lms Index
ACA	Acacia Mining Plc
ACC	Access Intelligence Plc
ACD	Acencia Debt Strategies Ltd
ACDAPR	FTSE Developed Asia Paci
ACDER	FTSE Developed Europe Al
ACDF	Ashmore Sicav
ACDXUSR	FTSE Developed Ex US All
ACHL	Asian Citrus Holdings Limited
ACID	Acer Incorporated
ACIM	SSGA SPDR ETFS Europe I Plc
ACL	Acal Plc
ACNAN	FTSE North America All C
ACNANCH	FTSE North America All C
ACNANEU	FTSE North America All C
ACNANUK	FTSE North America All C
ACO	Acorn Minerals Plc
ACP	Armadale Capital Plc
ACSO	Accesso Technology Group
ACT	Actual Experience Plc
ACWD	SSGA SPDR ETFS Europe I Plc
ACWI	SSGA SPDR ETFS Europe I Plc
ACWL	Multi Units France
ACWU	Multi Units France
ACXUSS	FTSE Gloabl All Cap Ex U
AD01	FTSE Developed
AD02	FTSE Developed Ex US
AD03	FTSE Developed Ex North
AD04	FTSE Developed Ex UK
AD05	FTSE Developed Ex Japan
AD06	FTSE Developed Europe
AD07	FTSE Developed Europe Ex
AD09	FTSE Dev Lms Ex US Index
AD13	FTSE Dev Europe Lms Inde
AD17	FTSE Dev Lms Ex Na Index
AD20	FTSE Dev Europe Lms Ex U
ADA	Adams Plc
ADGO	Adgorithms Ltd
ADL	Andalas Energy and Power Plc
ADM	Admiral Group Plc
ADN	Aberdeen Asset Management Plc
ADT	Adept Telecom Plc
AE01	FTSE Emerging
AE08	Tesco Plc
AE57	Aviva Plc
AEC	Aec Education Plc
AEFS	Alcentra European Floating Rate Income F
AEG	Active Energy Group Plc
AEJ	Lyxor International Asse
AEJL	Lyxor International Asse
AEMC	Aberdeen Emerging Markets Investment Com
AEN	Andes Energia Plc
AEO	Aeorema Communications Plc
AEP	Anglo-Eastern Plantations Plc
AERO	Strat Aero Plc
AEWU	Aew UK REIT Plc
AEX	Aminex Plc
AEY	Antrim Energy Inc
AFC	Afc Energy Plc
AFG	Aquatic Foods Group Plc
AFHP	Afh Financial Group Plc
AFID	Afi Development Plc
AFMC	Aberdeen Frontier Markets Investment Com
AFN	Advfn Plc
AFPO	African Potash Limited
AFRB	Afi Development Plc
AFS	Amiad Water Systems Ltd
AFSL	Lyxor International Asse
AFSU	Lyxor International Asse
AG01	FTSE All-Emerging
AG02	FTSE All-Emerging Latin
AG03	FTSE All-Emerging Asia P
AG14	FTSE All-Emer Lms Index
AG15	FTSE All-Emer Latin Amer
AG16	FTSE All-Emer Asia Pacif
AG41	Northumbrian Water Finan
AG93	Safeway Plc
AG99	Glaxosmithkline Capital
AGAP	ETFS Commodity Securities Limited
AGCP	ETFS Commodity Securities Limited
AGGP	ETFS Commodity Securities Limited
AGIT	Aberforth Geared Income Trust Plc
AGIZ	Aberforth Geared Income Trust Plc
AGK	Aggreko Plc
AGL	Angle Plc
AGM	Applied Graphene Materia
AGOL	Ashmore Global Opportunities Limited
AGOU	Ashmore Global Opportunities Limited
AGP	Asian Growth Properties Limited
AGQ	Arian Silver Corporation
AGR	Assura Group Ld
AGRI	Etfx Fund Company Plc
AGRO	Ros Agro Plc
AGRP	Etfx Fund Company Plc
AGRY	UBS Ag
AGTA	Agriterra Ld
AGY	Allergy Therapeutics Plc
AHCG	Action Hotels Plc
AHT	Ashtead Group Plc
AI68	National Grid Gas Plc
AIEA	Airea Plc
AIF	Acorn Income Fund Ld
AIFZ	Acorn Income Fund Ld
AIGA	ETFS Commodity Securities Limited
AIGC	ETFS Commodity Securities Limited
AIGE	ETFS Commodity Securities Limited
AIGG	ETFS Commodity Securities Limited
AIGI	ETFS Commodity Securities Limited
AIGL	ETFS Commodity Securities Limited
AIGO	ETFS Commodity Securities Limited
AIGP	ETFS Commodity Securities Limited
AIGS	ETFS Commodity Securities Limited
AIGX	ETFS Commodity Securities Limited
AIM1	FTSE Aim 100 Index
AIM5	FTSE Aim UK 50 Index
AIR	Air Partner Plc
AJG	Atlantis Japan Growth Fund Ld
AJIT	Aberdeen Japan Investmen
AKR	Akers Biosciences Inc.
AKRN	Jsc Acron
ALAG	Amundi ETF
ALAI	Aberdeen Latin American Income Fund Limi
ALAU	Amundi Investment Solutions
ALBA	Alba Mineral Resources Plc
ALBH	Aluminium Bahrain B.S.C.
ALD	Aldermore Group Plc
ALF	Alternative Liquidity Fu
ALLG	All Leisure Group Plc
ALM	Allied Minds Plc
ALO	Alecto Minerals Plc
ALP1	Alpha Plus Holdings Plc
ALP2	Alpha Plus Holdings Plc
ALPH	Alpha Pyrenees Trust Ltd
ALT	Altitude Group Plc
ALU	Alumasc Group Plc
ALUM	ETFS Commodity Securities Limited
ALY	Ashley [Laura] Holdings Plc
AMBR	Ambrian Plc
AMC	Amur Minerals Corporation
AMED	Amedeo Resources Plc
AMER	Amerisur Resources Plc
AMFW	Amec Foster Wheeler Plc
AMO	Amino Technologies Plc
AMP	Amphion Innovations Plc
AMPH	Aggregated Micro Power H
AMS	Advanced Medical Solutions Group Plc
AMYT	Amryt Pharma Plc
AN	ALTERNATIVE NETWORKS ORD GBP0.00125
AN94	Barclays Bank Plc
AN95	Barclays Bank Plc
ANA	All Nippon Airways Co Ld
ANCR	Animalcare Group Plc
ANDEAN40	FTSE Andean 40
ANP	Anpario Plc
ANR	Altona Energy Plc
ANRJ	Amundi Investment Solutions
ANTO	Antofagasta Plc
ANW	Aberdeen New Thai Investment Trust Plc
ANXG	Amundi ETF
ANXU	Amundi Investment Solutions
AO	AO World
AOF	Africa Opportunity Fund Limited
AOFC	Africa Opportunity Fund
AOMD	Ao Mosenergo
AOR	Aortech International Plc
APAX	Apax Global Alpha Limite
APC	Advanced Power Components Plc
APEF	Aberdeen Private Equity Fund Ld
APF	Anglo Pacific Group Plc
APGN	Applegreen Plc
APH	Alliance Pharma Plc
APT	Axa Property Trust Limited
ARBB	Arbuthnot Banking Group Plc
ARC	Arcontech Group Plc
ARDN	Arden Partners Plc
ARG	Argos Resources Limited
ARGO	Argo Group Limited
ARGP	Alpha Returns Group Plc
ARL	Atlantis Resources Limit
ARM	Arm Holdings Plc
ARO	Arricano Real Estate Plc
ARR	Aurora Investment Trust Plc
ARS	Asiamet Resources Limite
ARTA	Artilium Plc
ARTL	Alpha Real Trust Limited
ARW	Arrow Global Group Plc
ASA	ASA Resource Group Plc
ASAT	FTSE Asian Autos & Trucks Index
ASBA	FTSE Asian Banks Index
ASBE	Associated British Engineering Plc
ASBR	FTSE Asian Basic Resources Index
ASC	Asos Plc
ASCH	Aberdeen Smaller Companies High Income T
ASCI	Aberdeen Smaller Companies Income Trust
ASCL	Ascential Plc
ASCM	FTSE Asian Construction & Materials Inde
ASDV	SSGA SPDR ETFS Europe I
ASEAN40	FTSE Asean 40 Index
ASEAN40N	FTSE Asean 40
ASEANAS	FTSE Asean All-Share Ind
ASEANEM	FTSE Asean All-Share Ex
ASEANSTR	FTSE Asean Stars Index
ASECE	Ftse/Athex Capped 20 Index
ASECU	Ftse/Athex 20 Capped Index
ASFS	FTSE Asian Financial Services Index
ASH	Ashley House Plc
ASHC	FTSE Asian Health Care Index
ASHM	Ashmore Group Plc
ASHR	DB X-Trackers
ASIA	SSGA SPDR ETFS Europe I Plc
ASIG	FTSE Asian Industrial Goods & Services I
ASIL	Lyxor International Asse
ASIU	Lyxor International Asse
ASL	Aberforth Smaller Companies Trust Plc
ASPH	FTSE Asian Personal & Household Goods In
ASPL	Aseana Properties Limited
ASPR	FTSE Asian Personal & Household Goods In
ASRE	FTSE Asian Retail Index
AST	Ascent Resources Plc
ASTC	FTSE Asian Telecommunications Index
ASTE	FTSE Asian Technology Index
ASTL	FTSE Asian Travel Leisure & Media Index
ASTO	Assetco Plc
ASUT	FTSE Asian Utilities Index
ASX	FTSE All-Share
ASXDIGEQ	FTSE All Share Digital S
ASXX	FTSE All-Share [Exit]
ASY	Andrews Sykes Group Plc
AT2	Amati Vct 2 Plc
ATAD	Oao Tatneft
ATGOV01	FTSE Austria Government
ATI	Amati Vct Plc
ATK	Atkins [Ws] Plc
ATMA	Atlas Mara Co-Nvest Limi
ATQT	Attraqt Group Plc
ATR	Asian Total Return Inves
ATRF	Ashmore Sicav
ATS	Artemis Alpha Trust Plc
ATSS	Artemis Alpha Trust Plc
ATST	Alliance Trust Plc
ATT	Allianz Technology Trust
ATY	Athelney Trust Plc
ATYM	Atalaya Mining Plc
AUCO	Etfx Fund Company Plc
AUCP	Etfx Fund Company Plc
AUCT	Auctus Growth Plc
AUDP	ETFS Foreign Exchange Limited
AUE	Aureus Mining Inc.
AUEG	Amundi ETF
AUEM	Amundi Investment Solutions
AUG	Augean Plc
AUGB	ETFS Foreign Exchange Limited
AUK	Aukett Fitzroy Robinson Group Plc
AUKT	Aberdeen UK Tracker Trus
AUM	Aurasian Minerals Plc
AUP3	ETFS Foreign Exchange Li
AUR	Aurum Mining Plc
AUTO	Auto Trader Group Plc
AV	Aviva
AV.A	Aviva Plc
AV.B	Aviva Plc
AV20	Aviva Plc
AVA	Avanti Capital Plc
AVAP	Avation Plc
AVCT	Avacta Group Plc
AVG	Avingtrans Plc
AVGR	Avangardco Investments P
AVM	Avocet Mining Plc
AVN	Avanti Communications Group Plc
AVO	Advanced Oncotherapy Plc
AVON	Avon Rubber Plc
AVP	Armstrong Ventures Plc
AVR	Avarae Global Coins Plc
AVS	Avesco Group Plc
AVV	Aveva Group Plc
AW01	FTSE All World
AW02	FTSE All World Ex US
AW03	FTSE All World Ex UK
AW04	FTSE All World Ex Japan
AW05	FTSE All World Ex South
AW06	FTSE FTSE All World Asia
AW07	FTSE All World Asia Paci
AW08	FTSE All World Asia Pac
AW09	FTSE All World Asia Pac
AW10	FTSE All World Greater C
AW11	FTSE All World Europe
AW12	FTSE All World Europe Ex
AW13	FTSE All World Europe Ex
AW14	FTSE All World Eurobloc
AWALEMVN	FTSE Emerging Minimum Va
AWALLEN	FTSE Emerging Net of Tax
AWALLER	FTSE Emerging Net Tax (U
AWAMERS	FTSE Americas Index
AWDEUMVN	FTSE Developed Europe Mi
AWDEURSC	FTSE Developed Europe In
AWDEURSE	FTSE Developed Europe In
AWDEURSG	FTSE Developed Europe In
AWDEURU	FTSE Developed Europe Un
AWDPAC	FTSE Developed Asia Paci
AWDPACXJ	FTSE All-World Devlop Asia Pacific Exclu
AWDPCXJE	FTSE Developed Asia Paci
AWDPCXJG	FTSE Developed Asia Paci
AWDPXJC	FTSE Developed Asia Paci
AWDXNAR	FTSE Developed Ex North
AWDXNAU	FTSE Developed Ex North
AWEBCMVN	FTSE Eurobloc Minimum Va
AWHDY01	FTSE All-World High Divi
AWHDY01C	FTSE All-World High Divi
AWHDY01E	FTSE All-World High Divi
AWHDY01G	FTSE All-World High Divi
AWLDMVN	FTSE All-World Minimum Variance Net Tax Index
AWNAMERS	FTSE All-World North America Index
AWNT01HK	FTSE Japan Net Tax Hkd I
AWNT04	FTSE Developed Net Tax I
AWNT04CH	FTSE Developed Net Tax C
AWNT04EU	FTSE Developed Net Tax E
AWNT04UK	FTSE Developed Net Tax G
AWNT05	FTSE Developed Europe Ex
AWNT05CH	FTSE Developed Europe Ex
AWNT05EU	FTSE Developed Europe Ex
AWNT05UK	FTSE Developed Europe Ex
AWNT06HK	FTSE Developed Europe Ne
AWNT13	FTSE Developed Ex North
AWNT14	FTSE North America Net T
AWNT14CH	FTSE North America Net T
AWNT14EU	FTSE North America Net T
AWNT14UK	FTSE North America Net T
AWPXJANN	FTSE Asia Pacific Ex Jap
AXB	Axis Bank Limited
AXI	Axiom European Financial Debt Limited
AXM	Alexander Mining Plc
AXS	Accsys Technologies Plc
AXX	FTSE Aim All-Share Index
AYM	Anglesey Mining Plc
AZN	Astrazeneca Plc
BA	Bae Systems Plc
BA01	Forth Ports Authority
BA18	Thames Water Utilities F
BA47	City of London Investmen
BA97	Royal Bank of Scotland P
BAB	Babcock International Group Plc
BAC	Bank of America Corporation
BACK	Ishares IV Plc
BACS	Ishares IV Plc
BACT	Bacit Limited
BAF	British & American Investment Trust Plc
BAG	Barr [A.G.] Plc
BAGR	Bagir Group Ltd.
BAR	Eclectic Bar Group Plc
BARC	Barclays Plc
BATS	British American Tobacco Plc
BAUD	Bajaj Holdings & Investm
BAV	Baronsmead Vct 5 Plc
BB50	Barclays Bank Plc
BBA	Bba Aviation Plc
BBC30	FTSE Bbc Global 30 Index
BBEB	Ishares III Plc
BBEM	Multi Units France
BBGI	Bilfinger Berger Global Infrastructure S
BBOX	Tritax Big Box REIT Plc
BBSB	Ishares III Plc
BBSN	Brave Bison Group Plc
BBY	Balfour Beatty Plc
BBYB	Balfour Beatty Plc
BC12	Better Capital Pcc Limit
BC18	Sse Plc
BC41	Prudential Plc
BC62	National Grid Gas Plc
BC87	CANADIAN PACIFIC RAILWAYS 4% PERP CONS DEB STK GBP
BC94	Samsung Electronics Co L
BCA	Bca Marketplace
BCAP	Better Capital Pcc Limited
BCGR	Blue Capital Global Rein
BCN	Bacanora Minerals Ltd
BCRE	Bcre - Brack Capital Rea
BD45	Lewis (John) Partnership
BD56	National Grid Electricit
BD90	LOW & BONAR 5.5% 3RD CUM PRF STK GBP1
BDEV	Barratt Developments Plc
BDI	Bond International Software Plc
BE01	Beazley Plc
BEE	Baring Emerging Europe Plc
BEEP	Blackrock Emerging Europ
BEG	Begbies Traynor Group Plc
BEGOV01	FTSE Belgium Government
BEM	Beowulf Mining Plc
BEZ	Beazley Plc
BFA	Basf Se
BGEO	Bank of Georgia Holdings Plc
BGFD	Baillie Gifford Japan Trust Plc
BGHL	Boussard & Gavaudan Holding Limited
BGHS	Boussard & Gavaudan Holding Limited
BGLF	Blackstone / Gso Loan Fi
BGO	Bango Plc
BGS	Baillie Gifford Shin Nippon Plc
BHGG	Bh Global Limited
BHGU	Bh Global Limited
BHME	Bh Macro Limited
BHMG	Bh Macro Limited
BHMU	Bh Macro Limited
BHRD	BE Heard Group Plc
BHY	Boot [Henry] Plc
BILB	Bilby Plc
BILL	Billing Services Group Limited
BILN	Billington Holdings Plc
BIOG	Biotech Growth Trust [The] Plc
BIOM	Biome Technologies Plc
BISI	Bisichi Mining Plc
BIST	Blackrock Income Strateg
BJU	Brainjuicer Group Plc
BKG	Berkeley Group Holdings [The] Plc
BKIR	Bank of Ireland [Governor & Company of T
BKY	Berkeley Resources Limited
BL23	Scottish Power UK Plc
BLBD	Blom Bank Sal
BLEY	Bailey [C.H.] Plc
BLND	British Land Company Plc
BLNX	Blinkx Plc
BLP	Blue Planet International Financials Inv
BLT	Bhp Billiton Plc
BLTG	Blancco Technology Group Plc
BLU	Blue Star Capital Plc
BLUR	Blur (Group) Plc
BLV	Belvoir Lettings Plc
BLVN	Bowleven Plc
BMD	Baronsmead Vct 3 Plc
BME	B&M European Value Retai
BMK	Benchmark Holdings Plc
BMN	Bushveld Minerals Limited
BMR	Berkeley Mineral Resources Plc
BMS	Braemar Shipping Services Plc
BMT	Braime [T.F. & J.H.] [Holdings] Plc
BMV	Bluebird Merchant Ventures Ltd
BMY	Bloomsbury Publishing Plc
BNC	Banco Santander S.A.
BNK	Bankers Petroleum Limited
BNKR	Bankers Investment Trust Plc
BNR	Blenheim Natural Resources Plc
BNZL	Bunzl Plc
BOD	Botswana Diamonds Plc
BOE	Boeing Co.
BOI	Bank of Ireland [Governor & Company of T
BOIL	Baron Oil Plc
BOK	Booker Group Plc
BON	Bonmarche Holdings Plc
BOO	Boohoo.Com Plc
BOOM	Audioboom Group Plc
BOR	Borders & Southern Petroleum Plc
BOTB	Best of The Best Plc
BOY	Bodycote Plc
BP	Bp - British Petroleum Plc
BP.A	BP Plc
BP.B	BP Plc
BPC	Bahamas Petroleum Company Plc
BPI	British Polythene Industries Plc
BPM	B.P. Marsh & Partners Plc
BQAD	Bank Audi S.A.L.
BQE	Bioquell Plc
BR06	HSBC Bank Plc
BR88	3I Group Plc
BRAM	Brammer Plc
BRBY	Burberry Group Plc
BRCI	Blackrock Commodities Income Investment
BRD	Bluerock Diamonds Plc
BREE	Breedon Aggregates Ld
BREM	British Empire Securities & General Trus
BRFI	Blackrock Frontiers Investment Trust Plc
BRGE	Blackrock Greater Europe Investment Trus
BRGS	Blackrock Greater Europe
BRH	Braveheart Investment Group Plc
BRIC	Ishares II Plc
BRICUL2X	FTSE BRIC 50 2X Daily Su
BRICUL3X	FTSE BRIC 50 3X Daily Le
BRICUS1X	FTSE BRIC 50 Daily Short
BRICUS2X	FTSE BRIC 50 2X Daily Sh
BRICUS3X	FTSE BRIC 50 3X Daily Sh
BRIG	Blackrock Income and Growth Investment T
BRK	Brooks Macdonald Group Plc
BRLA	Blackrock Latin American Investment Trus
BRNA	Blackrock North American
BRND	Boost Issuer Public Limi
BRNT	ETFS Commodity Securities Limited
BRSC	Blackrock Smaller Co Trust Plc
BRSN	Berendsen Plc
BRU1	Bruntwood Investments Pl
BRW	Brewin Dolphin Holdings Plc
BRWM	Blackrock World Mining Trust Plc
BRY	Brady Plc
BRZ	Amundi Investment Solutions
BSC	British Smaller Companies Vct2 Plc
BSD	B.S.D Crown Ltd
BSE	Base Resources Limited
BSIF	Bluefield Solar Income F
BSRT	Baker Steel Resources Trust Limited
BSV	British Smaller Companies Vct Plc
BT.A	Bt Group Plc
BTEM	British Empire Securities & General Trus
BTG	Btg Plc
BULL	ETFS Commodity Securities Limited
BULP	ETFS Commodity Securities Limited
BUPF	Bupa Finance Plc
BUR	Burford Capital Limited
BUR1	Burford Capital Plc
BUR2	Burford Capital Plc
BUT	Brunner Investment Trust Plc
BUYB	Powershares Glbal Funds
BVA	Banco Bilbao Vizcaya Argentaria Sa
BVC	Batm Advanced Communications Ld
BVIC	Britvic Plc
BVM	Belgravium Technologies Plc
BVS	Bovis Homes Group Plc
BVT	Baronsmead Vct 2 Plc
BVXP	Bioventix Plc
BWNG	Brown [N] Group Plc
BWRA	Bristol Water Plc
BWSA	Bristol & West Plc
BWY	Bellway Plc
BXP	Beximco Pharmaceuticals Limited
BYBG	Amundi ETF
BYBU	Amundi ETF
BYG	Big Yellow Group Plc
BYOT	Byotrol Plc
BZM	Bellzone Mining Plc
BZT	Bezant Resources Plc
C21	21St Century Technology
C4XD	C4X Discovery Holdings P
CACX	Lyxor International Asse
CAD	Cadogan Petroleum Plc
CADP	ETFS Foreign Exchange Limited
CAF	China Africa Resources Plc
CAF1	Retail Charity Bonds Plc
CAKE	Patisserie Holdings Plc
CAL	Capital & Regional Plc
CAM	Camellia Plc
CAMB	Cambria Automobiles Plc
CAML	Central Asia Metals Plc
CAPC	Capital & Counties Properties Plc
CAPD	Capital Drilling Limited
CAPE	Ossiam Lux
CAPU	Ossiam Lux
CAR	Carclo Plc
CARB	ETFS Oil Securities Limited
CARD	Card Factory Plc
CARP	ETFS Oil Securities Limited
CARR	Carr's Group Plc
CASE	Go Ucits ETF Solutions P
CASH	Go Ucits ETF Solutions P
CAT	Catco Reinsurance Opportunities Fund Lim
CATC	Catco Reinsurance Opportunities Fund Lim
CATL	ETFS Commodity Securities Limited
CAU	Centaur Media Plc
CAY	Charles Stanley Group Plc
CAZA	Caza Oil & Gas Inc
CB5	Amundi ETF
CBE0	Ishares Vii Plc
CBE3	Ishares Vii Plc
CBE7	Ishares Vii Plc
CBG	Close Brothers Group Plc
CBKD	Commercial International
CBP	Curtis Banks Group Plc
CBQS	The Commercial Bank of Q
CBR1	Ishares Vii Plc
CBU0	Ishares Vii Plc
CBU3	Ishares Vii Plc
CBU7	Ishares Vii Plc
CBUY	Cloudbuy Plc
CC1U	Amundi ETF
CCAP	Charlemagne Capital Limited
CCAU	Ishares Vii Plc
CCC	Computacenter Plc
CCH	Coca-Cola Hbc Ag
CCJI	CC Japan Income & Growth Trust Plc
CCL	Carnival Plc
CCP	Celtic Plc
CCPA	Celtic Plc
CCPC	Celtic Plc
CCPE	Cvc Credit Partners Euro
CCPG	Cvc Credit Partners Euro
CCR	C&C Group Plc
CCSL	Chenavari Capital Soluti
CCT	Character Group Plc
CD6	Amundi ETF
CDFF	Cardiff Property Plc
CDI	Candover Investments Plc
CDIS	SSGA SPDR ETFS Europe II
CDOG	Cdialogues Plc
CE01	Ishares Vii Plc
CE31	Ishares Vii Plc
CE71	Ishares Vii Plc
CE9G	Amundi ETF
CE9U	Amundi ETF
CEA1	Ishares Vii Plc
CECD	Lyxor International Asse
CECL	Lyxor International Asse
CEIR	Compal Electronics Inc
CEMA	CS ETF [Ie] Plc
CEPS	Ceps Plc
CER	Cerillion Plc
CES1	Ishares Vii Plc
CEU	CS ETF [Ie] Plc
CEU1	Ishares Vii Plc
CEUR	Amundi Investment Solutions
CEUS	CS ETF [Ie] Plc
CEY	Centamin Plc
CFHS	Cathay Financial Holding
CFR	Amundi Investment Solutions
CFX	Colefax Group Plc
CFYN	Caffyns Plc
CG1	Amundi ETF
CGB	DB X-Trackers II
CGH	Chaarat Gold Holdings Ltd
CGI	Canadian General Investments Ld
CGNR	Conroy Gold & Natural Resources Plc
CGP	Cogenpower Plc
CGS	Castings Plc
CGT	Capital Gearing Trust Plc
CGW	Chelverton Growth Trust Plc
CH1	Amundi ETF
CH5	Amundi ETF
CH80	FTSE China Index
CHA	Concha Plc
CHAL	Challenger Acquisitions
CHAR	Chariot Oil & Gas Limited
CHE	Ojsc Cherkizovo Group
CHG	Chemring Group Plc
CHGB	ETFS Foreign Exchange Limited
CHH	Churchill China Plc
CHL	Churchill Mining Plc
CHNA	Source CSOP Markets Plc
CHNP	Source CSOP Markets Plc
CHOC	United Cacao Limited Sez
CHOO	Jimmy Choo Plc
CHRT	Cohort Plc
CHT	Constellation Healthcare
CI1	Amundi ETF
CI2U	Amundi ETF
CIC	Conygar Investment Company Plc [The]
CICZ	Conygar Zdp Plc
CID1	Ishares Vii Plc
CIFU	Carador Income Fund Plc
CIHL	Caribbean Investment Holdings Limited
CIN	City of London Group Plc
CIND	CS ETF [Ie] Plc
CINE	Cineworld Group Plc
CIR	Circassia Pharmaceutical
CIRC	Circle Holdings Plc
CITY	Cityfibre Infrastructure Holdings Plc
CIU	Cape Plc
CJ1U	Amundi ETF
CJPU	Ishares Vii Plc
CKN	Clarkson Plc
CKR1	Ishares Vii Plc
CLDN	Caledonia Investments Plc
CLG	Clipper Logistics Plc
CLI	Cls Holdings Plc
CLIG	City of London Investment Group Plc
CLIN	Clinigen Group Plc
CLL	Cello Group Plc
CLLN	Carillion Plc
CLNR	Cluff Natural Resources Plc
CLON	Clontarf Energy Plc
CLP	Clear Leisure Plc
CLS1	Cls Holdings Plc
CLSU	Clearstar Inc.
CLTV	Cellcast Plc
CMB	Cambria Africa Plc
CMB1	Ishares Vii Plc
CMBN	Cambian Group Plc
CMCL	Caledonia Mining Corporation
CMCX	Cmc Markets Plc
CMFP	Etfx Fund Company Plc
CMHY	City Merchants High Yield Trust Limited
CMIB	CS ETF [Ie] Plc
CML	Cml Microsystems Plc
CMS	Communisis Plc
CMU	Amundi Investment Solutions
CMX	Catalyst Media Group Plc
CMX1	Ishares Vii Plc
CMXC	CS ETF [Ie] Plc
CN1	Amundi ETF
CNA	Centrica Plc
CNAA	Multi Units France
CNC	Concurrent Technologies Plc
CNCT	Connect Group Plc
CNDX	CS ETF [Ie] Plc
CNE	Cairn Energy Plc
CNEL	China New Energy Limited
CNG	China Nonferrous Gold Li
CNIC	Centralnic Group Plc
CNKS	Cenkos Securities Plc
CNKY	CS ETF [Ie] Plc
CNMI	Camper & Nicholsons Marina Investments L
CNN	Caledonian Trust Plc
CNR	Condor Gold Plc
CNS	Corero Network Security Plc
CNSD	China Steel Corporation
CNX1	Ishares Vii Plc
CNYA	Ishares IV Plc
COA	Coats Group Plc
COB	Cobham Plc
COCG	UBS Ag
COCO	ETFS Commodity Securities Limited
COD	Compagnie De Saint Gobain Sa
COFF	ETFS Commodity Securities Limited
COG	Cambridge Cognition Hold
COGG	Go Ucits ETF Solutions P
COMF	Etfx Fund Company Plc
COMS	Coms Plc
CON	Connemara Mining Company Plc
COP	Circle Oil Plc
COPA	ETFS Commodity Securities Limited
COPL	Canadian Overseas Petrol
COR	Coretx Holdings Plc
CORE	Go Ucits ETF Solutions P
CORG	Go Ucits ETF Solutions P
CORN	ETFS Commodity Securities Limited
CORP	Ishares Plc
COS	Collagen Solutions Plc
COST	Costain Group Plc
COTN	ETFS Commodity Securities Limited
COUK	Multi Units France
CPG	Compass Group Plc
CPI	Capita Plc
CPJ1	Ishares Vii Plc
CPP	Cppgroup Plc
CPR	Carpetright Plc
CPS	Cpl Resources Plc
CPX	Cap-Xx Limited
CPXJ	CS ETF [Ie] Plc
CRAW	Crawshaw Group Plc
CRBL	Lyxor International Asse
CRBU	Lyxor International Asse
CRC	Circle Property Plc
CRDA	Croda International Plc
CRE	Creston Plc
CRED	Go Ucits ETF Solutions P
CREG	Go Ucits ETF Solutions P
CREI	Custodian REIT Plc
CRGH	Go Ucits ETF Solutions Plc
CRH	CRH Plc
CRL	Creightons Plc
CRN	Cairn Homes Plc
CRND	Central Rand Gold Limited
CRNL	Lyxor International Asse
CRNO	Lyxor International Asse
CRON	Cronin Group Plc
CROS	Crossrider Plc
CRPH	Ishares Vi Plc (The Comp
CRPR	Cropper [James] Plc
CRPS	Ishares Plc
CRPX	Lyxor International Asse
CRRY	Lam Zyfin Global Markets Ucits ETF Plc
CRS	Crystal Amber Fund Limited
CRST	Crest Nicholson Holdings
CRU	Coral Products Plc
CRU1	Ishares Vii Plc
CRUD	ETFS Commodity Securities Limited
CRV	Craven House Capital Plc
CRW	Craneware Plc
CRWN	Crown Place Vct Plc
CRWU	Ossiam Lux
CRX	Cyprotex Plc
CS1	Amundi ETF
CS5	Amundi ETF
CS51	Ishares Vii Plc
CSBR	CS ETF [Ie] Plc
CSCA	CS ETF [Ie] Plc
CSFG	Csf Group Plc
CSG	Sweett Group Plc
CSH2	Lyxor Index Fund
CSHD	Lyxor International Asse
CSIA	Multi Units France
CSIL	Multi Units France
CSJP	CS ETF [Ie] Plc
CSKR	CS ETF [Ie] Plc
CSN	Chesnara Plc
CSP	Countryside Properties Plc
CSP1	Ishares Vii Plc
CSPX	CS ETF [Ie] Plc
CSRT	Consort Medical Plc
CSRU	CS ETF [Ie] Plc
CSSG	Croma Security Solutions Group Plc
CSTP	SSGA SPDR ETFS Europe II
CSUK	CS ETF [Ie] Plc
CSUS	CS ETF [Ie] Plc
CSWG	Amundi ETF
CSWU	Amundi ETF
CSX5	Ishares Vii Plc
CT5	Amundi ETF
CTAG	Cloudtag Inc
CTG	Christie Group Plc
CTH	Caretech Holdings Plc
CTI	Cathay International Holdings Ld
CTO	Clarke [T.] Plc
CTP	Castleton Technology Plc
CTR	Charles Taylor Plc
CTY	City of London Investment Trust Plc
CTYA	City of London Investment Trust Plc
CU01	Ishares Vii Plc
CU1	Ishares Vii Plc
CU2G	Amundi ETF
CU2U	Amundi ETF
CU31	Ishares Vii Plc
CU71	Ishares Vii Plc
CUK	Amundi Investment Solutions
CUKS	CS ETF [Ie] Plc
CUKX	CS ETF [Ie] Plc
CUS1	Ishares Vii Plc
CUSS	CS ETF [Ie] Plc
CVB	Coventry Building Society
CVBP	Coventry Building Society
CVR	Conviviality Retail Plc
CVSG	CVS Group Plc
CW8U	Amundi ETF
CWC	Cable & Wireless Communications Plc
CWD	Countrywide Plc
CWEG	Amundi ETF
CWEU	Amundi ETF
CWFG	Amundi ETF
CWK	Cranswick Plc
CWR	Ceres Power Holdings Plc
CYAN	Cyan Holdings Plc
CYBG	Cybg Plc
CYN	City Natural Resources High Yield Trust
CYNC	City Natural Resources High Yield Trust
CYS	Chrysalis Vct Plc
CZA	Coal of Africa Limited
CZB	Commerzbank Ag
D467	Downing Four Vct Plc
D4OO	Downing Four Vct Plc
D4SO	Downing Four Vct Plc
DAIP	Daily Internet Plc
DAL	Dalata Hotel Group Plc
DALR	Dalradian Resources Inc.
DATA	Globaldata Plc
DAXX	Multi Units Luxembourg
DBRC	Ishares II Plc
DC	Dixons Carphone
DCC	Dcc Plc
DCD	Dcd Media Plc
DCG	Dairy Crest Group Plc
DCI	Dolphin Capital Investors Limited
DCP	Diamondcorp Plc
DDD	DDD Group Plc
DDDD	4D Pharma Plc
DDV1	Downing One Vct Plc
DEB	Debenhams Plc
DEGOV01	FTSE Germany Government
DEIN	Ishares II Plc
DEL2	Go Ucits ETF Solutions P
DEM	Wisdomtree Issuer Plc
DEMA	Wisdomtree Issuer Plc
DEMAEIV	Wisdomtree Emerging Asia Equity Income U
DEMD	Wisdomtree Issuer Plc
DEMEIV	Wisdomtree Emerging Mark
DEMG	Deltex Medical Group Plc
DEMP	Wisdomtree Issuer Plc
DEMV	Ossiam Lux
DES2	Go Ucits ETF Solutions P
DESE	Wisdomtree Issuer Plc
DESEEIV	Wisdomtree US Smallcap D
DFE	Wisdomtree Issuer Plc
DFEE	Wisdomtree Issuer Plc
DFEIV	Wisdomtree Europe Smallc
DFS	Dfs Furniture Plc
DFX	Defenx Plc
DGB	Digital Barriers Plc
DGE	Diageo Plc
DGED	Diageo Plc
DGS	Digital Globe Services
DGSD	Wisdomtree Issuer Plc
DGSE	Wisdomtree Issuer Plc
DGSEEIV	Wisdomtree Emerging Mark
DH2O	Ishares II Plc
DHS	Wisdomtree Issuer Plc
DHSD	Wisdomtree Issuer Plc
DHSEIV	Wisdomtree US Equity Inc
DIA	Dialight Plc
DIG	Dunedin Income Growth Investment Trust P
DIGS	Gcp Student Living Plc
DIL2	Damille Investments II L
DIS	Distil Plc
DISG	Multi Units Luxembourg
DISW	Multi Units Luxembourg
DIVI	Diverse Income Trust [The] Plc
DJAN	Daejan Holdings Plc
DJEL	Lyxor International Asse
DJI	Dji Holdings Plc
DJMC	Ishares Plc
DJSC	Ishares Plc
DKL	Dekeloil Public Limited
DKUS	FTSE Nasdaq Dubai Kuwait 15 Shariah Inde
DKUW	FTSE Nasdaq Dubai Kuwait 15 Index
DL2P	Go Ucits ETF Solutions P
DLAR	De La Rue Plc
DLG	Direct Line Insurance Gr
DLN	Derwent London Plc
DLTM	Ishares II Plc
DMGT	Daily Mail & General Trust Plc
DNA	Doric Nimrod Air One Limited
DNA2	Doric Nimrod Air Two Lim
DNA3	Doric Nimrod Air Three L
DNDL	Dunedin Smaller Companies Investment Tru
DNE	Dunedin Enterprise Investment Trust Plc
DNL	Diurnal Group Plc
DNLM	Dunelm Group Plc
DNRG	Ishares II Plc
DO1O	Downing Four Vct Plc
DODS	Dods [Group] Plc
DOM	Domino's Pizza Group Plc
DOTD	Dotdigital Group Plc
DP2F	Downing Two Vct Plc
DP2G	Downing Two Vct Plc
DPA	Dp Aircraft I Limited
DPH	Dechra Pharmaceuticals Plc
DPLM	Diploma Plc
DPP	Dp Poland Plc
DQAS	FTSE Nasdaq Dubai Qatar 10 Shariah Index
DQAT	FTSE Nasdaq Dubai Qatar 10 Index
DREF	Duet Real Estate Finance Limited
DRG	Draganfly Investments Limited
DRS	Drs Data & Research Services Plc
DRTY	Darty Plc
DRV	Driver Group Plc
DRX	Drax Group Plc
DS2P	Go Ucits ETF Solutions P
DSG	Dillistone Group Plc
DSUG	Multi Units France
DSUK	Multi Units France
DSUS	Multi Units France
DTC	Datatec Limited
DTG	Dart Group Plc
DTY	Dignity Plc
DUAE	FTSE Nasdaq Dubai UAE 20 Index USD
DUAED	FTSE Nasdaq Dubai UAE 20 Index Aed
DUKE	Duke Royalty Limited
DUPD	Dragon-Ukrainian Properties & Developmen
DVO	Devro Plc
DVT	Davictus Plc
DVUK	Source Markets II Plc
DVUS	Source Markets II Plc
DVW	Dee Valley Group Plc
DVWA	Dee Valley Group Plc
DWCG	DW Catalyst Fund Limited
DWCU	DW Catalyst Fund Limited
DWHA	Dewhurst Plc
DWHT	Dewhurst Plc
DWOD	Ishares II Plc
DX	DX Group
DXGEEIV	Wt Geequcetfusdhine
DXGP	Wisdomtree Issuer Plc
DXGPIV	Wisdomtree Germany Equit
DXGY	Wisdomtree Issuer Plc
DXGYEIV	Wisdomtree Germany Equity Ucits ETF - EU
DXJ	Wisdomtree Issuer Plc
DXJEIV	Wisdomtree Japan Equity
DXJFEIV	Wisdomtree Japan Equity Ucits ETF - EUR
DXJG	Wisdomtree Issuer Plc
DXJPEIV	Wt Jpequcetfgbphine
DXJZ	Wisdomtree Issuer Plc
DXJZEIV	Wisdomtree Japan Equity Ucits ETF - Jpy
E0500	FTSE Eurofirst Oil & Gas
E0EU	FTSE Epra/Nareit Euro Zo
E0RA	FTSE Epra/Nareit Europe
E0UK	FTSE Epra/Nareit Europe
E1300	FTSE Eurofirst Chemicals
E1700	FTSE Eurofirst Basic Res
E1X	FTSE Eurotop 100
E20Y	Ishares IV Plc
E2300	FTSE Eurofirst Construct
E2700	FTSE Eurofirst Industria
E2V	E2V Technologies Plc
E3300	FTSE Eurofirst Automobil
E3500	FTSE Eurofirst Food & BE
E3700	FTSE Eurofirst Personal
E3X	FTSE Eurofirst 300
E3X0001	FTSE Efst300 Oil & Gas
E3X0530	FTSE Efst300 Oil & Gas P
E3X0580	Ftseurofirst 300 Alterna
E3X1000	FTSE Efst300 Basic Mater
E3X1350	FTSE Efst300 Chemicals
E3X1730	FTSE Efst300 Forestry &
E3X1750	FTSE Efst300 Industrial
E3X1770	FTSE Efst300 Mining
E3X2000	FTSE Efst300 Industrials
E3X2350	FTSE Efst300 Constructio
E3X2710	FTSE Efst300 Aerospace &
E3X2720	FTSE Efst300 General Ind
E3X2730	FTSE Efst300 Electronic&
E3X2750	FTSE Efst300 Industrial
E3X2770	FTSE Efst300 Industrial
E3X2790	FTSE Efst300 Support Ser
E3X3000	FTSE Efst300 Consumer Go
E3X3350	FTSE Efst300 Automobiles
E3X3530	FTSE Efst300 Beverages
E3X3570	FTSE Efst300 Food Produc
E3X3720	FTSE Efst300 Household G
E3X3760	FTSE Efst300 Personal Go
E3X3780	FTSE Efst300 Tobacco
E3X4000	FTSE Efst300 Health Care
E3X4530	FTSE Efst300 Health Care
E3X4570	FTSE Efst300 Pharmaceuti
E3X5000	FTSE Efst300 Consumer Se
E3X5330	FTSE Efst300 Food & Drug
E3X5370	FTSE Efst300 General Ret
E3X5550	FTSE Efst300 Media
E3X5750	FTSE Efst300 Travel & Le
E3X6000	FTSE Efst300 Telecommuni
E3X6530	FTSE Efst300 Fixed Line
E3X6570	FTSE Efst300 Mobile Tele
E3X7000	FTSE Efst300 Utilities
E3X7530	FTSE Efst300 Electricity
E3X7570	FTSE Efst300 Gas Water &
E3X8000	FTSE Efst300 Financials
E3X8350	FTSE Efst300 Banks
E3X8530	FTSE Efst300 Nonlife Ins
E3X8570	FTSE Efst300 Life Insura
E3X8630	Ftseurofirst 300  Real Estate Investment
E3X8670	FTSE Eurofirst 300 Real
E3X8770	FTSE Efst300 General Fin
E3X9000	FTSE Efst300 Technology
E3X9530	FTSE Efst300 Software&Co
E3X9570	FTSE Efst300 Technology
E4500	FTSE Eurofirst Health CA
E5300	FTSE Eurofirst Retail
E5500	FTSE Eurofirst Media
E5700	FTSE Eurofirst Travel &
E6500	FTSE Eurofirst Telecommu
E7500	FTSE Eurofirst Utilities
E8300	FTSE Eurofirst Banks
E8500	FTSE Eurofirst Insurance
E8600	FTSE Eurofirst Supersect
E8700	FTSE Eurofirst Financial
E9500	FTSE Eurofirst Technolog
EAH	Eco Animal Health Group Plc
EAS	Energy Assets Group Plc
EAT	European Assets Trust Nv
EB0500	FTSE Eurofirst Euro Oil
EB1300	FTSE Eurofirst Euro Chem
EB16	European Investment Bank
EB1700	FTSE Eurofirst Euro Basi
EB1X	FTSE Euro 100
EB2300	FTSE Eurofirst Euro Cons
EB2700	FTSE Eurofirst Euro Indu
EB3300	FTSE Eurofirst Euro Auto
EB3500	FTSE Eurofirst Euro Food
EB3700	FTSE Eurofirst Euro Pers
EB4500	FTSE Eurofirst Euro Heal
EB5300	FTSE Eurofirst Euro Reta
EB5500	FTSE Eurofirst Euro Medi
EB5700	FTSE Eurofirst Euro Trav
EB6500	FTSE Eurofirst Euro Tele
EB7500	FTSE Eurofirst Euro Util
EB8300	FTSE Eurofirst Euro Bank
EB8500	FTSE Eurofirst Euro Insu
EB8600	FTSE Eurofirst Eurozone
EB8700	FTSE Eurofirst Euro Fina
EB9500	FTSE Eurofirst Euro Tech
EBGOV01	FTSE All Eurozone Govern
EBGOV03	FTSE All Eurozone Govern
EBGOV05	FTSE All Eurozone Govern
EBGOV07	FTSE All Eurozone Govern
EBGOV10	FTSE All Eurozone Govern
EBGOV30	FTSE All Eurozone Govern
EBQ	Ebiquity Plc
ECEL	Eurocell Plc
ECK	Eckoh Plc
ECM	Electrocomponents Plc
ECR	Ecr Minerals Plc
ECWL	Ecofin Water & Power Opportunities Plc
ECWO	Ecofin Water & Power Opportunities Plc
ECWZ	EW&Po Finance Plc
EDEN	Eden Research Plc
EDGC	Edge Performance Vct Plc
EDGD	Edge Performance Vct Plc
EDGE	Edge Performance Vct Plc
EDGF	Edge Performance Vct Plc
EDHAPAC	FTSE Edhec Risk Asia/Pacific
EDHAPXJ	FTSE Edhec Risk Asia/Pacific Ex JP
EDHAW	FTSE Edhec Risk All World
EDHAWXUK	FTSE Edhec Risk All Ex UK
EDHAWXUS	FTSE Edhec Risk All Ex US
EDHDAXJ	FTSE Edhec-Risk Efficient Developed Asia
EDHDEUR	FTSE Edhec Risk Dvlp EUR
EDHDEUXU	FTSE Edhec Risk Dvlp EUR Ex UK
EDHDEV	FTSE Edhec Risk Dvlp
EDHDXJ	FTSE Edhec Risk Eff Dev Japan
EDHDXUS	FTSE Edhec-Risk Efficien
EDHEBLOC	FTSE Edhec-Risk Efficient Eurobloc Index
EDHEMER	FTSE Edhec Risk Emerging
EDHJPN	FTSE Edhec Efficient Japan
EDHUK	FTSE Edhec Risk UK
EDHUSA	FTSE Edhec Risk US
EDIN	Edinburgh Investment Trust Plc
EDL	Edenville Energy Plc
EDP	Electronic Data Processing Plc
EDR	Egdon Resources Plc
EDV	Elderstreet Vct Plc
EDVD	SSGA SPDR ETFS Europe I Plc
EEI	Wisdomtree Issuer Plc
EEIE	Wisdomtree Issuer Plc
EEIIV	Wisdomtree Europe Equity
EEMB	Ishares II Plc
EEP	Eastern European Property Fund Limited
EEUI	FTSE Epra/Nareit Developed EMEA Index
EEX5	Ishares III Plc
EEXF	Ishares III Plc
EF80	FTSE Eurofirst 80
EFC1	FTSE Eurofirst 100
EFGD	Efg-Hermes Holding S.A.E
EFID	Edita Food Industries S.
EFIS	Source Markets Public Li
EFIW	Source Markets Public Li
EFM	Edinburgh Dragon Trust Plc
EFMC	Edinburgh Dragon Trust Plc
EG20	Ishares IV Plc
EGAS	Epra Asia Index [Eur]
EGIL	Ishares III Plc
EGNA	Epra North America Index
EGS	EG Solutions Plc
EGXU	Epra/Nareit Global [Ex Us] Index
EHG	Elegant Hotels Group Plc
EHP	Epistem Holdings Plc
EIMI	Ishares Plc
EKF	Ekf Diagnostics Holdings Plc
EKT	Elektron Technology Plc
ELA	Eland Oil & Gas Plc
ELAU	Epra Australia Index
ELCO	Eleco Plc
ELE	Electric Word Plc
ELHK	Epra Hong Kong Index
ELJP	Epra Japan Index
ELLA	Ecclesiastical Insurance Office Plc
ELM	Elementis Plc
ELOW	SSGA SPDR ETFS Europe II
ELSA	Societatea Comerciala De
ELTA	Electra Private Equity Plc
ELTZ	Electra Private Equity Investments Plc
ELUK	Epra UK Index
ELUKNUK	FTSE Epra/Nareit UK Net
ELX	El Oro Ltd
EMAD	SSGA SPDR ETFS Europe I Plc
EMAN	Everyman Media Group Plc
EMAS	SSGA SPDR ETFS Europe I Plc
EMBB	SSGA SPDR ETFS Europe II
EMBE	Ishares Vi Plc (The Comp
EMCB	SSGA SPDR ETFS Europe I
EMCO	SSGA SPDR ETFS Europe I
EMCP	Ishares V Public Limited Company
EMCR	Ishares V Public Limited Company
EMDD	SSGA SPDR ETFS Europe I Plc
EMDL	SSGA SPDR ETFS Europe I Plc
EMDV	SSGA SPDR ETFS Europe I Plc
EME	Empyrean Energy Plc
EMG	Man Group Plc
EMH	European Metals Holdings Limited
EMH5	SSGA SPDR ETFS Europe II
EMIL	SSGA SPDR ETFS Europe I
EMIM	Ishares Plc
EMIN	SSGA SPDR ETFS Europe I
EMIS	Emis Group Plc
EMLA	SSGA SPDR ETFS Europe I Plc
EMLB	Pimco Fixed Income Source ETFS Plc
EMLD	SSGA SPDR ETFS Europe I Plc
EMLI	Pimco Fixed Income Sourc
EMLP	Pimco Fixed Income Sourc
EMM	Emerging Market Minerals
EMMV	Ishares Vi Plc (The Comp
EMOD	SSGA SPDR ETFS Europe I Plc
EMR	Empresaria Group Plc
EMRD	SSGA SPDR ETFS Europe I Plc
EMRG	SSGA SPDR ETFS Europe I Plc
EMSM	SSGA SPDR ETFS Europe I Plc
EMUE	SSGA SPDR ETFS Europe I
EMUL	Ishares IV Plc
EMUM	Ishares IV Plc
EMUU	Ishares Vii Plc
EMV	Ishares Vi Plc (The Comp
EMXB	SSGA SPDR ETFS Europe II
ENA3	FTSE Epra/Nareit Asia 33
ENAD	Epra/Nareit Asia Index [Us Version]
ENDEM	FTSE Epra/Nareit Developed Ex Mea Index
ENDP	FTSE Epra Europe Ex UK Dividend +
ENEA	FTSE Epra/Nareit Emer Asia Pac Index
ENEE	FTSE Epra/Nareit Europe Non-Reit
ENEF	ETFS Commodity Securities Limited
ENEI	FTSE Epra/Nareit Emerging Index
ENEL	FTSE Epra/Nareit Emer Americas Index
ENEM	FTSE Epra/Nareit Emerging EMEA Index
ENER	UBS Ag
ENEU	FTSE Epra/Nareit Emerging Europe Index
ENFX	ETFS Foreign Exchange Li
ENGD	Epra/Nareit Global Index
ENGI	Energiser Investments Plc
ENGL	Epra Global Index
ENGY	SSGA SPDR ETFS Europe II
ENHA	FTSE Epra/Nareit Americas Index
ENHE	FTSE Epra/Nareit Global Ex US Index
ENHG	FTSE Epra/Nareit Global Index
ENHM	FTSE Epra/Nareit Middle East and Africa
ENHN	FTSE Epra/Nareit EMEA Index
ENHP	FTSE Epra/Nareit Asia Pacific Index
ENHU	FTSE Epra/Nareit Europe Index
ENME	FTSE Epra/Nareit Emer M East&Africa Idx
ENQ	Enquest Plc
ENQ1	Enquest Plc
ENRT	Environmental Recycling Tech. Plc
ENTU	Entu (Uk) Plc
ENUD	Epra/Nareit US Index
ENXGUS	FTSE  Epra/Nareit Global
EO100	FTSE Env Opportunities 1
EOAIM	FTSE Evm Opport Aim Index
EOAP	FTSE Evm Opport Asia Pac Index
EOAS	FTSE Env Opp All-Shares Idx
EOAX	FTSE Evm Opport Asia Pac Ex-Japan Index
EOEE	FTSE Env Opp Energy Eff Idx
EOEE50	FTSE Env Opp Energy Eff
EOEU	FTSE Evm Opport Europe Index
EOG	Europa Oil & Gas [Holdings] Plc
EOJP	FTSE Evm Opportjapan Index
EORE	FTSE Env Opp Re+Alt Energy Eff Idx
EORE50	FTSE Env Opp Re+Alt Ener
EOUK	FTSE Evm Opport UK Index
EOUS	FTSE Evm Opport US Index
EOWP	FTSE Env Opp Waste+Pollution Control Idx
EOWP30	FTSE Env Opp Waste+Pollu
EOWR	FTSE Env Opp Water Tech Index
EOWR30	FTSE Env Opp Water Tech
EPEU	Epra Euro Zone Index
EPG	Ep Global Opportunities Trust Plc
EPHG	Epra Europe [Uk Restricted] Index
EPIC	Ediston Property Investm
EPO	Earthport Plc
EPRA	Epra Europe Index
EPRE	Amundi ETF
EPWN	Epwin Group Plc
EQN	Equiniti Group Plc
EQQQ	Powershares Glbal Funds Ireland Plc
EQQU	Powershares Glbal Funds
EREE	FTSE Epra/Nareit Europe REIT
ERET	European Real Estate Inv
ERGO	Ergomed Plc
ERM	Euromoney Institutional Investor Plc
ERN1	Ishares IV Plc
ERND	Ishares IV Plc
ERNE	Ishares IV Plc
ERNS	Ishares IV Plc
ERNU	Ishares IV Plc
ERO	SSGA SPDR ETFS Europe II
ERO1	Eros International Plc
ES15	Ishares Plc
ESCH	Escher Group Holdings Public Limited Com
ESG	Eservglobal Limited
ESGOV01	FTSE Spain Government To
ESNT	Essentra Plc
ESO	Epe Special Opportunities Plc
ESP	Empiric Student Property
ESR	Ensor Holdings Plc
ESUR	Esure Group Plc
ET	Establishment Investment Trust
ET100	FTSE Et100
ET50	FTSE Et50 Index
ETI	Enterprise Inns Plc
ETLN	Etalon Group Limited
ETO	Entertainment One Limited
ETX	E-Therapeutics Plc
EU5L	Sg Issuer
EU5S	Sg Issuer
EUA	Eurasia Mining Plc
EUAG	SSGA SPDR ETFS Europe I
EUCF	Ishares Vi Plc (The Comp
EUCO	SSGA SPDR ETFS Europe I
EUDI	SSGA SPDR ETFS Europe I Plc
EUDV	SSGA SPDR ETFS Europe I Plc
EUE	Ishares II Plc
EUHD	Powershares Glbal Funds Ireland Plc
EULC	Ishares IV Plc
EUN	Ishares II Plc
EUP3	ETFS Foreign Exchange Li
EUP5	ETFS Foreign Exchange Limited
EURCORPA	
EURE	SSGA SPDR ETFS Europe I
EURL	SSGA SPDR ETFS Europe I
EURO	SSGA SPDR ETFS Europe I
EURP	ETFS Foreign Exchange Limited
EUSC	SSGA SPDR ETFS Europe II
EUSP	EU Supply Plc
EUT	The European Investment Trust Plc
EUXS	Ishares Plc
EVG	Evgen Pharma Plc
EVO	Evocutis Plc
EVR	Evraz Plc
EVRH	Evr Holdings Plc
EWG	EW Group Limited
EWI	Edinburgh Worldwide Investment Trust Plc
EXFN	Ishares II Plc
EXI	Exillon Energy Plc
EXO	Exova Group Plc
EXPN	Experian Plc
EYE	Eagle Eye Solutions Grou
EZH	Easyhotel Plc
EZJ	Easyjet Plc
EZXU	Source Markets Public Li
F4GAS	Ftse4Goodaseanind
F4GEM	Ftse4Goodemergind
F4GLA	Ftse4Goodemlatamind
FAGR	ETFS Commodity Securities Limited
FAIG	ETFS Commodity Securities Limited
FAIR	Fair Oaks Income Fund Li
FAL	Falcon Acquisitions Limited
FAM	Finnaust Mining Plc
FAN	Volution Group Plc
FARN	Faron Pharmaceuticals Oy
FAS	Fidelity Asian Values Plc
FAUSA	FTSE Asfa Australia All-Share Index
FAUSLC	FTSE Asfa Australia Large Cap 50 Index
FAUSLMC	FTSE Asfa Australia 200 Index
FAUSMC	FTSE Asfa Australia Mid Cap 150 Index
FAUSO	FTSE Asfa Australia 100 Index
FAUSSC	FTSE Asfa Australia Small Cap Index
FAUST	FTSE Asfa Australia 300 Index
FAUSX	FTSE Asfa Australia All-Share Ex 100 Ind
FBBRC	FTSE Beyond Brics Index
FBBRCN	FTSE Beyond Brics Net of
FBDU	Flying Brands Ld
FBH	Fbd Holdings Plc
FBRIC	FTSE BRIC 50 Index
FBRIC50	FTSE Rafi BRIC Index
FBRT	ETFS Commodity Securities Limited
FBT	Forbidden Technologies Plc
FCCN	French Connection Group Plc
FCI	F&C Capital & Income Investment Trust Pl
FCIF	Funding Circle Sme Income Fund Limited
FCNBCA	
FCNBCG	
FCPT	F&C Commercial Property Trust Limited
FCR	Ferrum Crescent Limited
FCRE	F&C UK Real Estate Inves
FCRM	Fulcrum Utility Services Ld
FCRU	ETFS Commodity Securities Limited
FCS	F&C Global Smaller Companies Plc
FCSC	F&C Global Smaller Compa
FCSE	FTSE Cse Morocco 15 Index
FCSELIQ	FTSE Cse Morocco All-Liquid Index
FCSS	Fidelity China Special Situations Plc
FDAPQVY5	FTSE Developed Asia Pacific Qual/Vol/Yie
FDBK	Feedback Plc
FDEFQVY5	FTSE Developed Europe Qual/Vol/Yield 5%
FDEV	Frontier Developments Pl
FDI	Firestone Diamonds Plc
FDL	Findel Plc
FDM	Fdm Group (Holdings) Plc
FDP	First Derivatives Plc
FDSA	Fidessa Group Plc
FDXUCPFR	FTSE Developed Ex US Comprehensive Facto
FDXULBR	FTSE Developed Ex US Low Beta Equal Weig
FECPFR	FTSE Emerging Comprehensive Factor Net T
FEDF	Multi Units Luxembourg
FEDS	Federal Bank Limited (Th
FEES	Jsc Federal Grid Company
FEET	Fundsmith Emerging Equit
FEM	First Trust Global Funds
FEMU	First Trust Global Funds
FEN	Frenkel Topping Group Plc
FENR	Fenner Plc
FEUZ	First Trust Global Funds
FEV	Fidelity European Values Plc
FEVR	Fevertree Drinks Plc
FEX	First Trust Global Funds
FEXD	First Trust Global Funds
FEXU	First Trust Global Funds
FF50	FTSE Frontier 50 Index
FFWD	Fastforward Innovations Limited
FFX	Fairfx Group Plc
FFY	Fyffes Plc
FGCHN150	FTSE Greaterchin150
FGP	Firstgroup Plc
FGT	Finsbury Growth & Income Trust Plc
FH01	FTSE Asiatop Index
FH02	FTSE Asiatop Capped
FIF	Finsbury Food Group Plc
FIGOV01	FTSE Finland Government
FIND	ETFS Commodity Securities Limited
FING	Multi Units Luxembourg
FINW	Multi Units Luxembourg
FIPP	Frontier Ip Group Plc
FISH	Fishing Republic Plc
FITB	Fitbug Holdings Plc
FIVE	X5 Retail Group N.V
FJET	Fastjet Plc
FJP	First Trust Global Funds
FJV	Fidelity Japanese Values Plc
FJVS	Fidelity Japanese Values Plc
FKL	Falkland Islands Holdings Plc
FKU	First Trust Global Funds
FKUD	First Trust Global Funds Public Limited
FLFQVVF	FTSE Latin America Qual/
FLIV	ETFS Commodity Securities Limited
FLK	Fletcher King Plc
FLKS	FTSE Lujain Kuwait Shariah Index
FLKW	FTSE Lujain Kuwait Index
FLO	Flowtech Fluidpower Plc
FLOW	Flowgroup Plc
FLX	Falanx Group Limited
FLYB	Flybe Group Plc
FMIBI1	FTSE MIB Short Strategy
FMIBI1X	FTSE MIB Daily Short Str
FMIBI2	FTSE MIB Daily Super Sho
FMIBI2X	FTSE MIB Daily Super Sho
FMIBI3X	FTSE MIB Daily Ultra Sho
FMIBI5X	FTSE MIB Gross TR Index
FMIBL2	FTSE MIB Daily Leveraged
FMIBL2X	FTSE MIB Daily Leveraged
FMIBL3X	FTSE MIB Daily Super Lev
FMIBL4X	FTSE MIB Daily Ultra Lev
FMIBL5X	FTSE MIB TR Index
FMPG	F&C Managed Portfolio Trust Plc
FMPI	F&C Managed Portfolio Trust Plc
FN10	FTSE Nareit Equity Diver
FN11	FTSE Nareit Equity Healt
FN12	FTSE Nareit Equity Self
FN13C	FTSE Nareit Industrial/O
FN14	FTSE Nareit Equity Indus
FN15	FTSE Nareit Equity Offic
FN17	FTSE Nareit Equity Resid
FN17C	FTSE Nareit All Resident
FN18	FTSE Nareit Equity Apart
FN19	FTSE Nareit Equity Manuf
FN20	FTSE Nareit Equity Retai
FN20C	FTSE Nareit Retail Cappe
FN21	FTSE Nareit Equity Shopp
FN22	FTSE Nareit Equity Regio
FN23	FTSE Nareit Equity Free
FN24	FTSE Nareit Equity Lodgi
FN26	FTSE Nareit Timber
FN28	FTSE Nareit Infrastructu
FN42	FTSE Nareit Mortgage Hom
FN43	FTSE Nareit Mortgage Com
FNAR	FTSE Nareit All Reits
FNCL	SSGA SPDR ETFS Europe II
FNCO	FTSE Nareit Composite
FNER	FTSE Nareit Equity Reits
FNKEN1	FTSE Nse Kenya 15 Index
FNKEN2	FTSE Nse Kenya 25 Index
FNMR	FTSE Nareit Mortgage Reits
FNMRC	FTSE Nareit All Mortgage Capped Index
FNR5	FTSE Nareit Real Estate
FNRE	FTSE Nareit Equity
FOG	Falcon Oil & Gas Ltd.
FORT	Forterra Plc
FOUR	4Imprint Group Plc
FOX	Fox Marble Holdings Plc
FOXT	Foxtons Group Plc
FP	Friends Provident
FPEO	F&C Private Equity Trust Plc
FPET	ETFS Commodity Securities Limited
FPGAL	FTSE Portugal 20 Index
FPGALN	FTSE Portugal 20 Net Tax
FPM	Faroe Petroleum Plc
FPO	First Property Group Plc
FPX	First Trust Global Funds
FQCAACY	FTSE China A All Cap Ind
FQCAN	FTSE China A Net Tax Ind
FQCAY	FTSE China A Index
FQE	FTSE Emerging R/Qfii Ind
FQEAC	FTSE Emerging All Cap R/
FQEACN	FTSE Emerging All Cap R/
FQEACR	FTSE Emerging All Cap R/
FQECONQ	FTSE Emerging Incl China
FQECOQ	FTSE Emerging Incl China
FQEN	FTSE Emerging R/Qfii Net
FQM	First Quantum Minerals Ltd
FR10	FTSE Rafi 1000 Index
FR10N	FTSE Rafi US 1000 Net In
FR10Q	FTSE Rafi US 1000 Index
FR10QN	FTSE Rafi US 1000 Net In
FR15	FTSE Rafi US 1500 Index
FR15N	FTSE Rafi US 1500 MS Ind
FR15Q	FTSE Rafi US 1500 Mid Sm
FR15QN	FTSE Rafi US 1500 Mid Sm
FR30Q	FTSE Rafi US 3000 Index
FRAPXJQN	FTSE Rafi Asia Pacific E
FRAU200	FTSE Rafi Australia 200
FRAW3	FTSE Rafi All-World 3000
FRAW3Q	FTSE Rafi All World 3000
FRAWLVNU	FTSE Rafi All-World Low
FRAWLVQU	FTSE Rafi All-World Low
FRBR5	FTSE Rafi Brazil 50 Inde
FRCAN	FTSE Rafi Canada Index
FRCANQ	FTSE Rafi Canada Index -
FRCHEN	FTSE Rafi Switzerland Index
FRCL	Foreign & Colonial Investment Trust Plc
FRD	FTSE Rafi Dev 1000 Idx
FRDAPXJ	FTSE Rafi Dev Asia/Pac Ex Japan
FRDAPXJN	FTSE Rafi Dev Asia Pacific Ex Jap Net In
FRDAPXJQ	FTSE Rafi Developed Asia
FRDELVN	FTSE Rafi Developed Euro
FRDELVNU	FTSE Rafi Developed Low
FRDELVQ	FTSE Rafi Developed Euro
FRDELVQU	FTSE Rafi Developed Low
FRDQ	FTSE Rafi Developed 1000
FREIAWN	FTSE Rafi All-World Equi
FREIDEN	FTSE Rafi Developed Euro
FREIDXU	FTSE Rafi Dev Xusei
FREIDXUN	FTSE Rafi Equity Income Developed Ex US
FREIEM	FTSE Rafi EM Eq Inc
FREIEMN	FTSE Rafi Emerging Equit
FREIUKN	FTSE Rafi UK Equity Inco
FREIUSA	FTSE Rafi US Eq Inc
FREIUSAN	FTSE Rafi US Equity Inco
FREM	FTSE Rafi Emerging Index
FREMLVNU	FTSE Rafi USD Emerging L
FREMLVQU	FTSE Rafi Emerging Low V
FREMN	FTSE Rafi Emer Nt Index
FREMQ	FTSE Rafi Emerging Index
FREMQN	FTSE Rafi Emerging Net I
FRES	Fresnillo Plc
FREU	FTSE Europe Index
FREUQ	FTSE Rafi Europe Index -
FREZ	FTSE Rafi Eurozone Index
FRGBR1	FTSE Rafi UK 100 Index
FRGBR1N	FTSE Rafi UK 100 Net Ind
FRGBR1Q	FTSE Rafi UK 100 Index -
FRGBR3	FTSE Rafi UK 300 Index
FRGBR3Q	FTSE Rafi UK 300 Index -
FRGOV01	FTSE France Government T
FRHKG	FTSE Rafi Hong Kong/China Index
FRI	Frontier Resources Inter
FRITA3	FTSE Rfi Italy 30 Index
FRITA3Q	FTSE Rafi Italy 30 Index
FRJP350Q	FTSE Rafi Japan 350 Inde
FRJPN	FTSE Rafi Japan Index
FRJPN350	FTSE Rafi Japan 350 Inde
FRJPNQ	FTSE Rafi Japan Index -
FRJPNUH	FTSE Rafi Japan Index [Cad]
FRM	Formation Group Plc
FRP	Fairpoint Group Plc
FRR	Frontera Resources Corporation
FRSDEURN	FTSE Rafi Dveu Net Index
FRSDEURQ	FTSE Rafi Developed Euro
FRSDEURS	FTSE Rafi Developed Europe Mid Small
FRSDXUS	FTSE Rafi Developed Ex US Mid Small 1500
FRSDXUSN	FTSE Rafi Dev Ex US MS Index
FRSDXUSQ	FTSE Rafi Developed Mid
FRSWEAC	FTSE Rafi Sweden All Cap Index
FRTW100	Tsec Rafi Taian 100 Inde
FRTW50	Tsec Rafi Taian 50 Index
FRTWLVN	FTSE Rafi Twd Taiwan Low
FRUKLVN	FTSE Rafi UK Low Volatil
FRUKLVQ	FTSE Rafi UK Low Volatil
FRUR	FTSE Rafi US 100 Real Estate Index
FRUS500	FTSE Rafi US 500 Index
FRUSLVN	FTSE Rafi US Low Volatil
FRUSLVQ	FTSE Rafi US Low Volatil
FRUT	Frutarom Industries Ld
FRX1	FTSE Rafi Global Ex US 1
FRX1C	FTSE Rafi Global Ex US 1
FRX1N	FTSE Rafi Dev Ex US Inde
FRX1Q	FTSE Rafi Developed Ex U
FRX1QN	FTSE Rafi Developed Ex U
FRXR	FTSE Rafi Global Ex US Real Estate
FRXULVNU	FTSE Rafi Developed Ex U
FRXULVQU	FTSE Rafi Developed Ex U
FSEU	Ishares IV Plc
FSFL	Foresight Solar Fund Lim
FSJ	Fisher [James] & Sons Plc
FSTA	Fuller Smith & Turner Plc
FSTHA	FTSE Set All Shares Index
FSTHF	FTSE Set Fledgling Index
FSTHL	FTSE Set Large Cap Index
FSTHM	FTSE Set Mid Cap Index
FSTHMS	FTSE Set Mid Small Cap Index
FSTHS	FTSE Set Small Cap Index
FSTSH	FTSE Set Shariah Index
FSUS	Ishares IV Plc
FSV	Fidelity Special Values Plc
FSWD	Ishares IV Plc
FT40	Sga Societe Generale Acc
FT41	Sga Societe Generale Acc
FT42	Sga Societe Generale Acc
FT44	Sga Societe Generale Acc
FT45	Sga Societe Generale Acc
FT46	Sga Societe Generale Acc
FTAL	SSGA SPDR ETFS Europe I Plc
FTASBE	FTSE Asian Food & Beverage Index
FTASCH	FTSE Asian Chemicals Index
FTBRXX	FTSE Brazil Infrastructu
FTBRXXN	FTSE Brazil Infrastructu
FTC	Filtronic Plc
FTD	Foresight 3 Vct Plc
FTDCUN	FTSE All-World Cyclical
FTDDUN	FTSE Developed Defensive
FTECEN	FTSE Developed Europe Cy
FTEDEN	FTSE Developed Europe De
FTEMCUN	FTSE Emerging Cyclical N
FTEMDUN	FTSE Emerging Defensive
FTEMSLNU	FTSE Emerging Large Cap
FTEMSLU	FTSE Emerging Super Liqu
FTENNASN	FTSE Epra/Nareit North A
FTESLNE	FTSE Eurobloc Large Cap
FTESPSL	FTSE All Cap Spain Super
FTESPSLN	FTSE Spain Super Liquid
FTEUCEN	FTSE Eurobloc Cyclical N
FTEUDEN	FTSE Eurobloc Defensive
FTEUSLNE	FTSE Eurobloc Large Cap
FTF	Foresight 4 Vct Plc
FTICEN	FTSE Italy Cyclical Net
FTIDEN	FTSE Italy Defensive Net
FTJPEM	FTSE Emerging Diversifie
FTJPEMN	FTSE Emerging Diversifie
FTJPEU	FTSE Deveudivfactor
FTJPEUN	FTSE Deveudivfct Nt
FTJPGE	FTSE Developed Diversifi
FTJPGEN	FTSE Developed Diversifi
FTJPIN	FTSE Developed Ex North
FTJPINN	FTSE Developed Ex North
FTJPUS	Russell 1000 Diversified Factor Index
FTJSLY	FTSE Japan Large Cap Sup
FTJSLYN	FTSE Japan Large Cap Sup
FTSC	Foresight Solar Vct Plc
FTSD10	FTSE Asia Pac Small Cap
FTSD14	FTSE Dev Europe Small CA
FTSV	Foresight Solar Vct Plc
FTSWD	FTSE Shariah Developed Europe Index
FTUGAS	Epra/Nareit Asia Index [Usd]
FTUKCGN	FTSE UK Cyclical Net Ind
FTUKDGN	FTSE UK Defensive Net In
FTUKLSNG	FTSE UK Large Cap Super
FTUKMSLG	FTSE UK Mid Cap Super Li
FTUKMSNG	FTSE UK Mid Cap Super Li
FTUKSLSP	FTSE UK Large Cap Super Liquid Expiry Index
FTUSLNU	FTSE USA Large Cap Super
FTUSLU	FTSE USA Super Liquid In
FTUSSNU	FTSE USA Small Cap Super
FTUSSU	FTSE USA Small Cap Super
FTV	Foresight Vct Plc
FTVP	Foresight Vct Plc
FTXUKSNE	FTSE Developed Europe Ex
FUDP	FTSE UK Dividend+ Index
FUDPN	FTSE UK Dividend+ Net Ta
FUL	The Fulham Shore Plc
FUM	Futura Medical Plc
FUSYQVCF	FTSE USA Yield/Qual/Vol
FUTR	Future Plc
FVTT	FTSE Vietnam Index
FWEC	Go Ucits ETF Solutions P
FWEG	Go Ucits ETF Solutions P
FXC	Ishares Plc
FXI	Fusionex International P
FXPO	Ferrexpo Plc
FXRU	Finex Funds Plc
FXTM	FTSE China 50 Mini Index
G06	FTSE Asia Pac Lms Index
G07	FTSE Asia Pac Lms Ex Jap
G08	FTSE Asia Pac Lms Ex Jap
G09	FTSE Asia Pac Lms Ex JP
G10	FTSE Greater China Lms I
G11	FTSE Europe Lms Index
G12	FTSE Europe Lms Ex UK In
G14	FTSE Eurobloc Lms Index
G4M	Gear4Music (Holdings) Pl
GACA	General Accident Plc
GACB	General Accident Plc
GAH	Gable Holdings Inc.
GAID	Gail (India) Ld
GAL	Galantas Gold Corporation
GAMA	Gamma Communications Plc
GAME	Gameaccount Network Plc
GAN	Gameaccount Network Plc
GASD	Boost Issuer Public Limi
GAW	Games Workshop Group Plc
GAZ	Jsc Gazprom Neft
GB78	Goldman Sachs Internatio
GB82	Goldman Sachs Internatio
GBAU	ETFS Foreign Exchange Limited
GBCA	ETFS Foreign Exchange Limited
GBCH	ETFS Foreign Exchange Limited
GBDV	SSGA SPDR ETFS Europe I
GBG	Gb Group Plc
GBGR	Goldbridges Global Resou
GBJP	ETFS Foreign Exchange Limited
GBNO	ETFS Foreign Exchange Limited
GBNZ	ETFS Foreign Exchange Limited
GBP	Global Petroleum Limited
GBPCORPA	
GBPP	ETFS Foreign Exchange Limited
GBRE	SSGA SPDR ETFS Europe I
GBS	Gold Bullion Securities Ld
GBSK	ETFS Foreign Exchange Limited
GBSP	ETFS Hedged Metal Securi
GBSS	Gold Bullion Securities Ld
GBUR	ETFS Foreign Exchange Limited
GBUS	ETFS Foreign Exchange Limited
GCL	Geiger Counter Limited
GCLA	Grupo Clarin S.A.
GCM	Gcm Resources Plc
GCP	Gcp Infrastructure Investments Limited
GCVB	SSGA SPDR ETFS Europe II
GD07	FTSE Global Energy
GDG	Green Dragon Gas Ltd.
GDL	Greka Drilling Limited
GDP	Goldplat Plc
GDPECO	FTSE Emerging Incl China
GDPECON	FTSE Emerging Incl China
GDWN	Goodwin Plc
GDX	Market Vectors Ucits ETF
GDXJ	Market Vectors Ucits ETF
GEC	General Electric Company
GED	Global Energy Development Plc
GEEC	Great Eastern Energy Corporation Limited
GEF	Fundlogic Alternatives P
GEISAC	FTSE Gloabl All Cap Inde
GEL	Greka Engineering & Tech
GEM	Gemfields Plc
GEMD	Gem Diamonds Limited
GENL	Genel Energy Plc
GFIN	Gfinity Plc
GFIR	Global Fixed Income Real
GFM	Griffin Mining Limited
GFRD	Galliford Try Plc
GFS	G4S Plc
GFTU	Grafton Group Plc
GGP	Greatland Gold Plc
GHE	Gresham House Plc
GHEW	Gresham House Plc
GHG	Georgia Healthcare Group Plc
GHH	Gooch & Housego Plc
GHS	Gresham House Strategic Plc
GHT	Gresham Computing Plc
GHYS	Ishares Vi Plc (The Comp
GILI	Multi Units France
GILS	Multi Units France
GIN	SSGA SPDR ETFS Europe II
GINV	Global Invacom Group Lim
GIPO	Grand Group Investment P
GKN	Gkn Plc
GKP	Gulf Keystone Petroleum Ltd
GLAF	Gli Alternative Finance Plc
GLB	Glanbia Plc
GLD	Boost Issuer Public Limi
GLDG	UBS Ag
GLDV	SSGA SPDR ETFS Europe I
GLE	Gleeson [M.J.] Group Plc
GLEN	Glencore Xstrata Plc
GLIF	Greenwich Loan Income Fund Ld
GLIZ	Gli Finance Limited
GLOO	Gloo Networks Plc
GLPR	Global Ports Investments
GLR	Galileo Resources Plc
GLRE	SSGA SPDR ETFS Europe I
GLS	Galasys Plc
GLTD	Global Telecom Holding S
GLTL	SSGA SPDR ETFS Europe I Plc
GLTR	Globaltrans Investment P
GLTS	SSGA SPDR ETFS Europe I Plc
GLTY	SSGA SPDR ETFS Europe I Plc
GMAA	Gama Aviation Plc
GMD	Game Digital Plc
GMR	Gaming Realms Plc
GMS	Gulf Marine Services Plc
GNC	Greencore Group Plc
GNI	General Industries Plc
GNK	Greene King Plc
GNS	Genus Plc
GOAL	Goals Soccer Centres Plc
GOG	Go-Ahead Group Plc
GOLD	Randgold Resources Ld
GOOD	Good Energy Group Plc
GOVY	SSGA SPDR ETFS Europe I
GPBGI028	FTSE Custom Xinhua Chia
GPCSSA50	FTSE China A50 Shariah I
GPCST001	FTSE Coast Kuwait 40 Ind
GPFF001	FTSE Asfa L/M 200 Tax Ex
GPFF002	FTSE Asfa All-Share L/M/
GPFF003	FTSE Asfa L/M 200 Ex Rei
GPFF004	FTSE Asfa All-Share L/M/
GPM	Golden Prospect Precious Metals Limited
GPNIKK1	FTSE Japan Green Chip 35
GPNYL007	FTSE Germany Unhedged In
GPOR	Great Portland Estates Plc
GPPS005	FTSE Japan Unhedged USD
GPRT	Goldenport Holdings Inc.
GPSCW002	FTSE Developed Small Cap
GPSSG239	FTSE Greater China Hkd I
GPTRP006	FTSE Cuspacglhdntind
GPVAN001	FTSE Value-Stocks China
GPVAN013	FTSE Australia High Divi
GPVAN019	FTSE Canada All Cap Oil
GPVAN020	FTSE Canada All Cap Basi
GPVAN021	FTSE Canada All Cap Fina
GPVAN022	FTSE Canada All Cap Real
GPVAN025	FTSE Canada High Dividen
GPVAN044	FTSE Asia Pacific Ex JP
GPVAN045	FTSE Asia Pacific Ex JP
GPVAN090	FTSE All-World Ex US High Dividend Yield
GPVP002	FTSE Value-Stock China I
GPVP005	FTSE Value Stocks Taiwan
GPVP007	FTSE Value Stocks Korea
GPVP009	FTSE Value-Stocks China
GPVP010	FTSE Value Stocks Asean
GPVPJP	FTSE Value Stocks Japan Index
GPX	Gulfsands Petroleum Plc
GRA	Grafenia Plc
GRAF	ETFS Commodity Securities Limited
GRG	Greggs Plc
GRGOV01	FTSE Greece Government T
GRI	Grainger Plc
GRIO	Ground Rents Income Fund Plc
GRIT	Global Resources Investm
GRIW	Ground Rents Income Fund Plc
GRL	Goldstone Resources Limited
GRN	Green REIT Plc
GRPH	Graphene Nanochem Plc
GRTB	Guaranty Trust Bank Plc
GSH	Green & Smart Holdings Plc
GSK	Glaxosmithkline Plc
GSR	Golden Saint Resources L
GSS	Genesis Emerging Markets Fund Ld
GTC	Getech Group Plc
GTLY	Gateley (Holdings) Plc
GTS	Gts Chemical Holdings Pl
GUS	Gusbourne Plc
GVC	Gvc Holdings Plc
GVP	Gabelli Value Plus+ Trus
GWI	Globalworth Real Estate
GWIK	Glenwick Plc
GWMO	Great Western Mining Corporation Plc
GWP	Gw Pharmaceuticals Plc
GWUSA	FTSE Gwa US Index
GYM	The Gym Group Plc
H50E	HSBC ETFS Plc
HAIK	Haike Chemical Group Ltd
HALB	Halifax Plc
HALF	Sg Issuer
HALO	Halosource Inc.
HAN	Hansa Trust Plc
HANA	Hansa Trust Plc
HAS	Hays Plc
HAST	Henderson Alternative ST
HAT	H&T Group Plc
HAWK	Nighthawk Energy Plc
HAYD	Haydale Graphene Industr
HAYT	Hayward Tyler Group Plc
HB20	Helical Bar Plc
HBRL	HSBC ETFS Plc
HBRN	Hibernia REIT P.L.C.
HCAD	HSBC ETFS Plc
HCAN	HSBC ETFS Plc
HCFT	Highcroft Investments Plc
HCM	Hutchison China Meditech Limited
HDD	Hardide Plc
HDEU	Powershares Glbal Funds Ireland Plc
HDIQ	Ishares II Plc
HDIV	Henderson Diversified Income Limited
HDLG	Powershares Glbal Funds
HDLV	Powershares Glbal Funds
HDLVDEUN	FTSE Developed Europe Ex UK High Dividen
HDLVEMN	FTSE Emerging High Dividend Low Volatili
HDLVUKN	FTSE UK High Dividend Low Volatility Net
HDT	Holders Technology Plc
HDY	Hardy Oil & Gas Plc
HEAD	Headlam Group Plc
HEAT	ETFS Commodity Securities Limited
HEDF	Wisdomtree Issuer Plc
HEDFEIV	Wisdomtree Europe Equity Ucits ETF - EUR
HEDJ	Wisdomtree Issuer Plc
HEDJEIV	Wisdomtree Europe Equity
HEDP	Wisdomtree Issuer Plc
HEDPEIV	Wt Euequcetfgbphine
HEFT	Henderson European Focus Trust Plc
HER	Herencia Resources Plc
HEWA	HSBC ETFS Plc
HFD	Halfords Group Plc
HFEL	Henderson Far East Income Limited
HFG	Hilton Food Group Plc
HGG	Henderson Group Plc
HGM	Highland Gold Mining Ld
HGT	Hg Capital Trust Plc
HHI	Henderson High Income Trust Plc
HHPD	Hon Hai Precision Indust
HHV	Hargreave Hale Aim Vct 1 Plc
HHVT	Hargreave Hale Aim Vct 2 Plc
HICL	Hicl Infrastructure Company Ld
HIDD	HSBC ETFS Plc
HIDR	HSBC ETFS Plc
HIK	Hikma Pharmaceuticals Plc
HILS	Hill & Smith Holdings Plc
HINT	Henderson International Income Trust Plc
HIX	FTSE Actuaries 350 High Yield
HKLB	Hong Kong Land Holdings
HKOD	HSBC ETFS Plc
HKOR	HSBC ETFS Plc
HL	HARGREAVES LANSDOWN PLC ORD GBP0.004 WI
HLCL	Helical Bar Plc
HLMA	Halma Plc
HLTG	Multi Units Luxembourg
HLTW	Multi Units Luxembourg
HMAD	HSBC ETFS Plc
HMAF	HSBC ETFS Plc
HMBR	HSBC ETFS Plc
HMCD	HSBC ETFS Plc
HMCH	HSBC ETFS Plc
HMCX	HSBC ETFS Plc
HMED	HSBC ETFS Plc
HMEF	HSBC ETFS Plc
HMEM	HSBC ETFS Plc
HMEU	HSBC ETFS Plc
HMEX	HSBC ETFS Plc
HMFD	HSBC ETFS Plc
HMFE	HSBC ETFS Plc
HMI	Harvest Minerals Limited
HMJD	HSBC ETFS Plc
HMJP	HSBC ETFS Plc
HMLA	HSBC ETFS Plc
HMLD	HSBC ETFS Plc
HMLH	Hml Holdings Plc
HMSF	Highbridge Multi-Strategy Fund Limited
HMSG	Hms Hydraulic  Machines
HMSO	Hammerson Plc
HMUD	HSBC ETFS Plc
HMUS	HSBC ETFS Plc
HMWD	HSBC ETFS Plc
HMWO	HSBC ETFS Plc
HMXD	HSBC ETFS Plc
HMXJ	HSBC ETFS Plc
HMYD	HSBC ETFS Plc
HMYR	HSBC ETFS Plc
HNE	Henderson Eurotrust Plc
HNL	Hague & London Oil Plc
HNR	Highlands Natural Resour
HNT	Huntsworth Plc
HOC	Hochschild Mining Plc
HOGF	ETFS Commodity Securities Limited
HOGS	ETFS Commodity Securities Limited
HOME	Home Retail Group Plc
HON	Honeywell International Incorporated
HONY	Honeycomb Investment Trust Plc
HOT	Henderson Opportunites Trust Plc
HOTC	Hotel Chocolat Group Plc
HPAC	Hermes Pacific Investmen
HPRD	HSBC ETFS Plc
HPRO	HSBC ETFS Plc
HR1O	Hazel Renewable Energy V
HRG	Hogg Robinson Group Plc
HRI	Herald Investment Trust Plc
HRN	Hornby Plc
HRUB	HSBC ETFS Plc
HRUD	HSBC ETFS Plc
HS6B	HSBC Bank Plc
HS6D	HSBC Bank Plc
HS6G	HSBC Bank Plc
HS6H	HSBC Bank Plc
HSBA	HSBC Holdings Plc
HSBK	Jsc Halyk Bank
HSD	Hansard Global Plc
HSL	Henderson Smaller Companies Investment T
HSM	Heath [Samuel] & Sons Plc
HSP	Hargreaves Services Plc
HSPB	HSBC ETFS Plc
HSPD	HSBC ETFS Plc
HSPX	HSBC ETFS Plc
HSS	Hss Hire Group Plc
HSTG	Hastings Group Holdings Plc
HSTN	Hansteen Holdings Plc
HSV	Homeserve Plc
HSW	Hostelworld Group Plc
HSX	Hiscox Ltd
HTG	Hunting Plc
HTOP	Retail Charity Bonds Plc
HTRD	HSBC ETFS Plc
HTRY	HSBC ETFS Plc
HTWD	HSBC ETFS Plc
HTWN	HSBC ETFS Plc
HUKX	HSBC ETFS Plc
HUM	Hummingbird Resources Plc
HUN	Hunter Resources Plc
HUNT	Hunters Property Plc
HUR	Hurricane Energy Plc
HUW	Hampden Underwriting Plc
HVE	Havelock Europa Plc
HVN	Harvey Nash Group Plc
HVO	Hvivo Plc
HVPE	Harbourvest Global Private Equity Limite
HVT	Heavitree Brewery Plc
HW	Harwood Wealth Management
HWC	Highway Capital Plc
HWDN	Howden Joinery Group Plc
HWG	Harworth Group Plc
HWWA	HSBC ETFS Plc
HYD	Hydro International Plc
HYDG	Hydrogen Group Plc
HYDR	Jsc Rushydro
HYG	Hygea Vct Plc
HYLD	Ishares Plc
HYNS	Haynes Publishing Group Plc
HYR	Hydrodec Group Plc
HYUD	Hyundai Motor Company
HYUO	Hyundai Motor Company
HZAD	HSBC ETFS Plc
HZAR	HSBC ETFS Plc
HZD	Horizon Discovery Group
HZM	Horizonte Minerals Plc
IAAA	Ishares Vi Plc (The Comp
IAE	Ithaca Energy Inc
IAEX	Ishares Plc
IAG	International Consolidated Airlines Grou
IAP	Icap Plc
IAPD	Ishares Plc
IASH	Ishares IV Plc
IASP	Ishares II Plc
IAT	Invesco Asia Trust Plc
IAUP	Ishares V Public Limited Company
IAUS	Ishares III Plc
IBC1	Ishares Plc
IBCI	Ishares Plc
IBCX	Ishares Plc
IBEL	Ishares V Public Limited Company
IBEX	Ibex Global Solutions Pl
IBGE	Ishares III Plc
IBGL	Ishares II Plc
IBGM	Ishares II Plc
IBGS	Ishares Plc
IBGX	Ishares II Plc
IBGY	Ishares III Plc
IBGZ	Ishares III Plc
IBM	International Business Machines Corporat
IBPO	Ienergizer Ld
IBST	Ibstock Plc
IBT	International Biotechnology Trust Plc
IBTL	Ishares IV Plc
IBTM	Ishares II Plc
IBTS	Ishares Plc
IBZL	Ishares Plc
IC55	Icap Plc
ICDU	Ishares V Public Limited Company
ICG2	Intermediate Capital Gro
ICG3	Intermediate Capital Gro
ICG7	Intermediate Capital Gro
ICGC	Irish Continental Group Plc
ICGT	Icg Enterprise Trust Plc
ICOV	Ishares III Plc
ICP	Intermediate Capital Group Plc
ICTA	Investors Capital Trust Plc
ICTB	Investors Capital Trust Plc
ICTU	Investors Capital Trust Plc
IDAP	Ishares Plc
IDAR	Ishares II Plc
IDBT	Ishares Plc
IDBZ	Ishares Plc
IDEA	Ideagen Plc
IDEE	Ishares Plc
IDEM	Ishares Plc
IDEU	Ishares V Public Limited Company
IDFE	Ishares II Plc
IDFF	Ishares Plc
IDFX	Ishares Plc
IDH	Immunodiagnostic Systems Holdings Plc
IDHC	Integrated Diagnostics H
IDIN	Ishares II Plc
IDJG	Ishares Plc
IDJP	Ishares III Plc
IDJV	Ishares Plc
IDKO	Ishares Plc
IDNA	Ishares Plc
IDOX	Idox Plc
IDP6	Ishares III Plc
IDPE	Ishares II Plc
IDTK	Ishares II Plc
IDTL	Ishares IV Plc
IDTM	Ishares II Plc
IDTP	Ishares II Plc
IDTW	Ishares Plc
IDUP	Ishares II Plc
IDUS	Ishares Plc
IDVY	Ishares Plc
IDWP	Ishares II Plc
IDWR	Ishares Plc
IE15	Ishares III Plc
IEAC	Ishares III Plc
IEAG	Ishares III Plc
IEBB	Ishares III Plc
IEBC	Ishares III Plc
IECF	Ishares Vi Plc (The Comp
IEDY	Ishares V Public Limited Company
IEEM	Ishares Plc
IEER	Ishares Plc
IEFM	Ishares IV Plc
IEFQ	Ishares IV Plc
IEFS	Ishares IV Plc
IEFV	Ishares IV Plc
IEGA	Ishares III Plc
IEGE	Ishares III Plc
IEGL	Ishares II Plc
IEGM	Ishares II Plc
IEGOV01	FTSE Ireland Government
IEGS	Ishares Plc
IEGX	Ishares II Plc
IEGY	Ishares III Plc
IEGZ	Ishares III Plc
IEH	Intelligent Energy Holdi
IEM	Impax Environmental Markets Plc
IEMA	Ishares III Plc
IEMB	Ishares II Plc
IEMG	Ishares V Public Limited
IEMI	Ishares II Plc
IEML	Ishares III Plc
IEMO	Ishares IV Plc
IEMS	Ishares III Plc
IEQU	Ishares IV Plc
IESE	Ishares II Plc
IESG	Ishares II Plc
IESP	Ishares V Public Limited Company
IESU	Ishares V Public Limited Company
IESZ	Ishares IV Plc
IEUR	Ishares Plc
IEUT	Ishares Plc
IEUX	Ishares Plc
IEVL	Ishares IV Plc
IEX5	Ishares III Plc
IEXF	Ishares III Plc
IFFF	Ishares Plc
IFIN	Ishares V Public Limited Company
IFP	Ifg Group Plc
IFRB	Ishares V Public Limited Company
IFRE	Ishares IV Plc
IFSE	Ishares IV Plc
IFSU	Ishares IV Plc
IFSW	Ishares IV Plc
IGAS	Igas Energy Plc
IGC	India Capital Growth Fund Limited
IGCC	Ishares III Plc
IGCS	India Capital Growth Fun
IGE	Image Scan Holdings Plc
IGEA	Ishares III Plc
IGG	Ig Group Holdings Plc
IGHY	Ishares Plc
IGIL	Ishares III Plc
IGLN	Ishares Physical Metals Plc
IGLO	Ishares III Plc
IGLS	Ishares III Plc
IGLT	Ishares II Plc
IGP	Intercede Group Plc
IGR	International Greetings Plc
IGSD	Ishares IV Plc
IGSG	Ishares II Plc
IGSS	Ig Seismic Services Plc
IGSU	Ishares II Plc
IGUS	Ishares V Public Limited Company
IGV	Income & Growth Vct [The] Plc
IGWD	Ishares V Public Limited Company
IH2O	Ishares II Plc
IHC	Inspiration Healthcare G
IHCU	Ishares V Public Limited Company
IHG	Intercontinental Hotels Group Plc
IHUK	Impact Holdings [Uk] Plc
IHYG	Ishares Plc
IHYU	Ishares II Plc
III	3I Group Plc
IIP	Infrastructure India Plc
IIT	Independent Investment Trust Plc
IITB	Ishares V Public Limited Company
IITU	Ishares V Public Limited Company
IJPA	Ishares III Plc
IJPD	Ishares Plc
IJPE	Ishares MSCI Japan EUR Hedged
IJPH	Ishares V Public Limited Company
IJPN	Ishares Plc
IJPU	Ishares Plc
IKA	Ilika Plc
IKK	Inch Kenneth Kajang Rubber Plc
IKOR	Ishares Plc
IL0A	Permanent Tsb Group Hold
IMB	Imperial Brands
IME	Immedia Group Plc
IMEA	Ishares III Plc
IMEU	Ishares II Plc
IMG	Imagination Technologies Group Plc
IMI	IMI Plc
IMIB	Ishares II Plc
IMID	SSGA SPDR ETFS Europe I Plc
IMM	Immupharma Plc
IMO	Imimobile Plc
IMPT	Industrial Multi Propert
IMTK	Imaginatik Plc
IMV	Ishares Vi Plc (The Comp
INAA	Ishares Plc
INCH	Inchcape Plc
IND	Indigovision Group Plc
INDI	Indus Gas Limited
INDL	Multi Units France
INDO	Multi Units France
INDV	Indivior Plc
INDW	Multi Units Luxembourg
INF	Informa Plc
INFA	Infrastrata Plc
INFG	Multi Units Luxembourg
INFR	Ishares II Plc
INFT	Infinity Energy S.A
ING	Ingenta Plc
INL	Inland Homes Plc
INLD	Ishares V Public Limited Company
INLZ	Inland Zdp Plc
INM	Independent News & Media Plc
INPP	International Public Partnerships Ld
INRG	Ishares II Plc
INRL	Lyxor International Asse
INRU	Lyxor International Asse
INS	Instem Plc
INSE	Inspired Energy Plc
INSP	Inspirit Energy Holdings
INTQ	Internetq Plc
INTU	Intu Properties Plc
INUG	Multi Units Luxembourg
INV	Investment Company Plc
INVP	Investec Plc
INVR	Investec Plc
INXG	Ishares II Plc
IOF	Iofina Plc
IOG	Independent Oil & Gas Pl
IOGP	Ishares V Public Limited Company
IOM	Iomart Group Plc
IPDM	Ishares Physical Metals Plc
IPE	Invesco Perpetual Enhanc
IPEL	Impellam Group Plc
IPF	International Personal Finance Plc
IPF1	International Personal F
IPLT	Ishares Physical Metals Plc
IPO	Ip Group Plc
IPOL	Ishares V Public Limited Company
IPOS	FTSE Renaissance US Ipo Index
IPOSAP	FTSE Renaissance Asia Pacific Ex Japan I
IPOSC	FTSE Renaissance US Ipo Capped Index
IPOSCN	FTSE Renaissance Canada Ipo Index
IPOSE	FTSE Renaissance EMEA Ipo Index
IPOSEC	FTSE Renaissance EMEA Ipo Capped Index
IPOSEM	FTSE Renaissance Emerging Markets Ipo
IPOSG	FTSE Renaissance Global Ipo Index
IPOSGC	FTSE Renaissance Global Ipo Capped Index
IPOSHKT	FTSE Renaissance Hong Kong/China Top Ipo
IPOSLM	FTSE Renaissance Latin America Ipo Index
IPOSNA	FTSE Renaissance North America Ipo Index
IPOST	FTSE Renaissance US Ipo Investable Index
IPOSXJ	FTSE Renaissance Global Ex Japan Ipo Ind
IPOSXU	FTSE Renaissance Global Ex US Ipo Index
IPOUSA	Renaissance Ipo Index
IPOXUS	Ipox US Index
IPOXUSN	Ipox US Net Return Index
IPP	Ipplus Plc
IPRP	Ishares Plc
IPRV	Ishares II Plc
IPU	Invesco Perpetual UK Smaller Companies I
IPX	Impax Asset Management Group Plc
IPXJ	Ishares III Plc
IQE	Iqe Plc
IRCP	Ishares V Public Limited
IRG	Independent Resources Plc
IRHC	Ishares V Public Limited
IRON	Ironveld Plc
IRR	Ironridge Resources Limi
IRSA	Ishares III Plc
IRV	Interserve Plc
IS15	Ishares Plc
ISAC	Ishares V Public Limited Company
ISAG	Ishares V Public Limited Company
ISAT	Inmarsat Plc
ISBB	Ishares III Plc
ISDE	Ishares II Plc
ISDU	Ishares II Plc
ISDW	Ishares II Plc
ISEM	Ishares II Plc
ISEQ	Wisdomtree Issuer Plc
ISF	Ishares Plc
ISFE	Ishares II Plc
ISFR	Ishares IV Plc
ISJP	Ishares III Plc
ISL	Is Solutions Plc
ISLN	Ishares Physical Metals Plc
ISP6	Ishares III Plc
ISPY	Go Ucits ETF Solutions Plc
ISQE	Wisdomtree Issuer Plc
ISRL	Ishares IV Plc
ISUS	Ishares II Plc
ISWD	Ishares II Plc
ISXF	Ishares III Plc
ITE	Ite Group Plc
ITEC	SSGA SPDR ETFS Europe II
ITGOVP01	FTSE Italy Government To
ITKY	Ishares II Plc
ITM	Itm Power Plc
ITPS	Ishares II Plc
ITQ	Interquest Group Plc
ITRK	Intertek Group Plc
ITV	Itv Plc
ITWN	Ishares Plc
IUAG	Ishares II Plc
IUCD	Ishares V Public Limited Company
IUES	Ishares V Public Limited Company
IUFS	Ishares V Public Limited Company
IUHC	Ishares V Public Limited Company
IUIT	Ishares V Public Limited Company
IUKD	Ishares Plc
IUKP	Ishares II Plc
IUSA	Ishares Plc
IUSE	Ishares V Public Limited Company
IUSP	Ishares II Plc
IVI	Invesco Income Growth Trust Plc
IVO	Imperial Innovations Group Plc
IVPB	Invesco Perpetual Select Trust Plc
IVPG	Invesco Perpetual Select Trust Plc
IVPM	Invesco Perpetual Select Trust Plc
IVPU	Invesco Perpetual Select Trust Plc
IWDA	Ishares III Plc
IWDE	Ishares V Public Limited Company
IWDP	Ishares II Plc
IWFM	Ishares IV Plc
IWFQ	Ishares IV Plc
IWFS	Ishares IV Plc
IWFV	Ishares IV Plc
IWMO	Ishares IV Plc
IWQU	Ishares IV Plc
IWRD	Ishares Plc
IWSZ	Ishares IV Plc
IWVL	Ishares IV Plc
IXI	Ixico Plc
JAI	Jpmorgan Asian Investement Trust Plc
JAM	Jpmorgan American Investment Trust Plc
JAPAN	FTSE All-World Index Japan
JCH	Jpmorgan Claverhouse Investment Trust Pl
JD	John David Group
JDG	Judges Scientific Plc
JDT	Jupiter Dividend & Growth Trust Plc
JDTC	Jupiter Dividend & Growth Trust Plc
JDTZ	Jupiter Dividend & Growth Trust Plc
JDW	Wetherspoon [ J.D.] Plc
JE	Just Eat
JEL	Jersey Electricity Plc
JEMI	Jpmorgan Global Emerging Markets Income
JEO	Jupiter European Opportunities Trust Plc
JESC	Jpmorgan Euro Small Co. Trust Plc
JETG	Jpmorgan European Investment Trust Plc
JETI	Jpmorgan European Investment Trust Plc
JFJ	Jpmorgan Japanese Investment Trust Plc
JGC	Jupiter Green Investment Trust Plc
JGCI	Jpmorgan Global Converti
JHD	James Halstead Plc
JHDA	James Halstead Plc
JIGC	Jpmorgan Income & Growth Investment Trus
JIGI	Jpmorgan Income & Growth Investment Trus
JIGU	Jpmorgan Income & Growth Investment Trus
JII	Jpmorgan Indian Investment Trust Plc
JIL	Juridica Investments Limited
JIM	Jarvis Securities Plc
JKX	Jkx Oil & Gas Plc
JLEN	John Laing Environmental
JLG	John Laing Group Plc
JLH	John Lewis of Hungerford Plc
JLIF	John Laing Infrastructure Fund Limited
JLP	Jubilee Platinum Plc
JLT	Jardine Lloyd Thompson Group Plc
JMAT	Johnson Matthey Plc
JMC	Jpmorgan Chinese Investment Trust Plc
JMF	Jpmorgan Mid Capital Investment Trust Pl
JMG	Jpmorgan Emerging Markets Investment Tru
JMI	Jpmorgan Smaller Companies Investment TR
JMIS	Jpmorgan Smaller Compani
JMO	Jpmorgan Overseas Investment Trust Plc
JNKE	SSGA SPDR ETFS Europe I Plc
JNKS	SSGA SPDR ETFS Europe I
JNY	Journey Group Plc
JOG	Jersey Oil and Gas Plc
JPB	Jpmorgan Brazil Investment Trust Plc
JPE	Jpmorgan Elect Plc
JPEC	Jpmorgan Elect Plc
JPEH	SSGA SPDR ETFS Europe I Plc
JPEI	Jpmorgan Elect Plc
JPEL	J.P. Morgan Private Equity Ld
JPEX	Source Markets Public Li
JPGB	ETFS Foreign Exchange Limited
JPHG	Amundi ETF
JPI	Jpmorgan Income & Capital Trust Plc
JPIU	Jpmorgan Income & Capital Trust Plc
JPIZ	Jpmorgan Income & Capital Trust Plc
JPJP	SSGA SPDR ETFS Europe I Plc
JPM	Jpmorgan Chase & Co
JPNL	Lyxor International Asse
JPNU	Lyxor International Asse
JPP3	ETFS Foreign Exchange Li
JPR	Johnston Press Plc
JPRL	Jupiter Energy Limited
JPS	Jpmorgan Japan Smaller Co Tst Plc
JPSL	Jpmorgan Senior Secured
JPSR	UBS ETF
JPSS	Jpmorgan Japan Smaller C
JPSZ	J.P. Morgan Private Equity Ld
JPX4	Multi Units France
JPXG	Multi Units France
JPXU	Multi Units France
JPXX	Multi Units France
JRP	Just Retirement Group Plc
JRS	Jpmorgan Russian Securities Plc
JSG	Johnson Service Group Plc
JSI	Jiasen International Hol
JUKG	Jupiter UK Growth Investment Trust Plc
JUP	Jupiter Fund Management Plc
JUS	Jupiter US Smaller Compa
JUSC	Jpmorgan US Smaller Co. Inv Tst Plc
JWNG	Jaywing Plc
JZCC	Jz Capital Partners Limi
JZCN	Jz Capital Partners Limited
JZCP	Jz Capital Partners Limited
JZCZ	Jz Capital Partners Limited
KAKU	Kakuzi Ld
KAY	Kings Arms Yard Vct Plc
KAZ	Kazakhmys Plc
KBE	Kimberly Enterprises N.V.
KBT	K3 Business Technology Group Plc
KCEL	Kcell Joint Stock Compan
KCOM	Kcom Group Plc
KCR	K&C REIT Plc
KDR	Karelian Diamond Resources Plc
KEFI	Kefi Minerals Plc
KEM	Kemin Resources Plc
KENV	Kennedy Ventures Plc
KGF	Kingfisher Plc
KGLD	Kolar Gold Limited
KGP	Kingspan Group Plc
KIBO	Kibo Mining Plc
KIE	Kier Group Plc
KIT	Keystone Investment Trust Plc
KKB	Jsc Kazkommertsbank
KLBT	Kalibrate Technologies P
KLN	Kellan Group [The] Plc
KLR	Keller Group Plc
KMG	Jsc Kazmunaigas Explorat
KMK	Kromek Group Plc
KMR	Kenmare Resources Plc
KNM	Konami Corporation
KNOS	Kainos Group Plc
KOD	Kodal Minerals Plc
KOOV	Koovs Plc
KRS	Keras Resources Plc
KRW	Lyxor International Asse
KRWL	Lyxor International Asse
KSK	Ksk Power Ventur Plc
KUBC	Kubera Cross-Border Fund Limited
KWE	Kennedy Wilson Real Esta
KWS	Keywords Studios Plc
KYGA	Kerry Group Plc
L100	Multi Units France
L250	Multi Units France
L6EW	Ossiam Lux
LAD	Ladbrokes Plc
LAD2	Ladbrokes Group Finance
LAGR	ETFS Commodity Securities Limited
LAKE	Lakehouse Plc
LALL	ETFS Commodity Securities Limited
LALU	ETFS Commodity Securities Limited
LAM	Lamprell Plc
LAND	Land Securities Group Plc
LAS	London & Associated Properties Plc
LAU3	ETFS Foreign Exchange Li
LAUD	ETFS Foreign Exchange Limited
LAUS	Multi Units Luxembourg
LAUU	Multi Units Luxembourg
LBG2	Lloyds Bank Plc
LBOW	Icg-Longbow Senior Secur
LBRT	ETFS Commodity Securities Limited
LBS	Leeds Building Society
LBUL	ETFS Commodity Securities Limited
LC53	Sga Societe Generale Acc
LC57	Sga Societe Generale Acc
LC64	Sga Societe Generale Acc
LCAD	ETFS Foreign Exchange Limited
LCAN	Multi Units Luxembourg
LCAU	Multi Units Luxembourg
LCFE	ETFS Commodity Securities Limited
LCG	London Capital Group Holdings Plc
LCHF	ETFS Foreign Exchange Limited
LCNP	ETFS Foreign Exchange Limited
LCOC	ETFS Commodity Securities Limited
LCOE	UBS Ag
LCOG	UBS Ag
LCOP	ETFS Commodity Securities Limited
LCOR	ETFS Commodity Securities Limited
LCPE	Ossiam Lux
LCRP	SSGA SPDR ETFS Europe I Plc
LCRW	Ossiam Lux
LCTO	ETFS Commodity Securities Limited
LDCU	Pimco Fixed Income Sourc
LDSG	Leeds Group Plc
LEAF	Leaf Clean Energy Company
LEF	Ludgate Environmental Fund Limited
LEG	Legendary Investments Plc
LEK	Lekoil Limited
LEMB	Multi Units France
LEMD	Lyxor International Asse
LEML	Lyxor International Asse
LEMV	Ossiam Lux
LEU3	ETFS Foreign Exchange Li
LEUR	ETFS Foreign Exchange Limited
LFAS	Multi Units France
LFI	London Finance & Investment Group Plc
LGAS	ETFS Commodity Securities Limited
LGB3	ETFS Foreign Exchange Li
LGB5	Sg Issuer
LGBP	ETFS Foreign Exchange Limited
LGCF	Source Markets Public Limited Company
LGCU	Source Markets Public Limited Company
LGEN	Legal & General Group Plc
LGLD	Lg Electronics Inc
LGO	Leni Gas & Oil Plc
LGRA	ETFS Commodity Securities Limited
LGT	Lighthouse Group Plc
LHEA	ETFS Commodity Securities Limited
LID	Lidco Group Plc
LIFE	Life Science Developments Limited
LIME	ETFS Commodity Securities Limited
LINP	ETFS Foreign Exchange Limited
LIO	Liontrust Asset Management Plc
LIV	Livermore Investments Group Limited
LIVN	Livanova Plc
LIX	FTSE Actuaries 350 Low Yield
LJP3	ETFS Foreign Exchange Li
LJP5	Sg Issuer
LKCS	Lucky Cement Limited
LKOD	Lukoil (Oao)
LKOH	Lukoil [Oao]
LKUU	Multi Units France
LKUW	Multi Units France
LLCT	ETFS Commodity Securities Limited
LLEA	ETFS Commodity Securities Limited
LLHO	ETFS Commodity Securities Limited
LLOY	Lloyds Banking Group Plc
LLPC	Lloyds Banking Group Plc
LLPD	Lloyds Banking Group Plc
LLPE	Lloyds Banking Group Plc
LLST	ETFS Commodity Securities Limited
LME	Limitless Earth Plc
LMI	Lonmin Plc
LMP	Londonmetric Property Pl
LMS	Lms Capital Plc
LND	Landore Resources Limited
LNGA	ETFS Commodity Securities Limited
LNIK	ETFS Commodity Securities Limited
LNOK	ETFS Foreign Exchange Limited
LNRG	ETFS Commodity Securities Limited
LNTA	Lenta Ltd
LNTR	Lenta Ltd
LOCG	Go Ucits ETF Solutions P
LOCL	Go Ucits ETF Solutions P
LOIL	ETFS Commodity Securities Limited
LOK	Lok'n Store Group Plc
LOOK	Lookers Plc
LOTS	Lotte Shopping Co. Ltd.
LOWE	SSGA SPDR ETFS Europe II
LOWV	SSGA SPDR ETFS Europe I
LPA	Lpa Group Plc
LPET	ETFS Commodity Securities Limited
LPLA	ETFS Commodity Securities Limited
LPMT	ETFS Commodity Securities Limited
LQDE	Ishares Plc
LQDG	Ishares Plc
LQDH	Ishares Plc
LRD	Laird Plc
LRE	Lancashire Holdings Limited
LRM	Lombard Risk Management Plc
LSE	London Stock Exchange Group Plc
LSE1	London Stock Exchange Gr
LSFT	ETFS Commodity Securities Limited
LSIC	Lifeline Scientific Inc
LSIL	ETFS Commodity Securities Limited
LSL	Lsl Property Services Plc
LSLI	London & ST Lawrence Investment Company
LSOB	ETFS Commodity Securities Limited
LSPU	Multi Units Luxembourg
LSPX	Multi Units Luxembourg
LSR	The Local Shopping REIT Plc
LSRG	Ojsc Lsr Group
LSUG	ETFS Commodity Securities Limited
LSYO	ETFS Commodity Securities Limited
LTAM	Ishares II Plc
LTG	Learning Technologies Gr
LTHM	Latham [James] Plc
LTHP	Latham [James] Plc
LTI	Lindsell Train Investment Trust Plc
LTIM	ETFS Commodity Securities Limited
LTML	Lyxor International Asse
LTMU	Lyxor International Asse
LTOD	Larsen and Toubro Limite
LUD5	ETFS Foreign Exchange Limited
LUK2	Go Ucits ETF Solutions P
LUMV	Ossiam Lux
LUSB	ETFS Foreign Exchange Li
LUSC	SSGA SPDR ETFS Europe I Plc
LUXU	Amundi ETF
LVD	Lavendon Group Plc
LVRT	Levrett Plc
LWB	Low & Bonar Plc
LWCG	Amundi ETF
LWDB	Law Debenture Corporation Plc
LWEA	ETFS Commodity Securities Limited
LWI	Lowland Investment Company Plc
LWMV	Ossiam Lux
LWRF	Lightwaverf Plc
LXB	Lxb Retail Properties Plc
LYX5	Lyxor Index Fund
LYXM	Lyxor Index Fund
LYXQ	Lyxor Index Fund
LYXS	Lyxor Index Fund
LYXV	Lyxor Index Fund
LZIC	ETFS Commodity Securities Limited
M0EB	FTSE Euromid Eurobloc
M0X	FTSE Euromid
M0XU	FTSE Euromid Ex UK
MAB	Mitchells & Butlers Plc
MAB1	Mortgage Advice Bureau (
MAC	Marechale Capital Plc
MACF	Macfarlane Group Plc
MAFL	Mineral & Financial Investment Ltd.
MAGI	SSGA SPDR ETFS Europe II
MAGP	Magnolia Petroleum Plc
MAI	Maintel Holdings Plc
MAIL	Mail.Ru Group Limited
MAJE	Majedie Investments Plc
MANX	Manx Telecom Plc
MARL	Mariana Resources Limited
MARS	Marston's Plc
MATD	Petro Matad Limited
MATW	Multi Units Luxembourg
MAV4	Maven Income & Growth Vc
MAVD	Magyar Telekom Telecommu
MAW	Maruwa Co. Ltd
MAYA	Mayair Group Plc
MBH	Michelmersh Brick Holdings Plc
MBSP	Manchester Building Society
MBT	Mobile Tornado Group Plc
MCAP	Retail Charity Bonds Plc
MCB	Mcbride Plc
MCC	Mercom Capital Plc
MCGN	Microgen Plc
MCIX	FTSE Mid 250 [Exit]
MCKS	Mckay Securities Plc
MCL	Morses Club Plc
MCLS	Mccoll's Retail Group Pl
MCO	Martinco Plc
MCON	Mincon Group Plc
MCP	Martin Currie Pacific Trust Plc
MCRO	Micro Focus International Plc
MCS	Mccarthy & Stone Plc
MCT	Middlefield Canadian Income Pcc
MCX	FTSE Mid 250
MCXI1X	FTSE 250 Daily Short Str
MCXI2X	FTSE 250 Daily Super Sho
MCXI3X	FTSE 250 Daily Ultra Sho
MCXL2X	FTSE 250 Daily Leveraged
MCXL3X	FTSE 250 Daily Super Lev
MCXL4X	FTSE 250 Daily Ultra Lev
MCXNUK	FTSE 250 Net Dividend Index
MCXNUKEU	FTSE 250 Net Tax EUR Ind
MDC	Mediclinic International Plc
MDMG	MD Medical Group Investm
MDZ	Mediazest Plc
MED	Medaphor Group Plc
MED1	FTSE Med 100
MEDI	Medilink-Global UK Limited
MEL	Mitsubishi Electric Corporation
MER	Mears Group Plc
MERC	Mercia Technologies Plc
MERL	Merlin Entertainments Pl
MES	Messaging International Plc
MEUG	Lyxor International Asse
MEUU	Lyxor International Asse
MEXI	Multi Units France
MEXL	Multi Units France
MF01	Societe Generale Effekte
MF04	Societe Generale Effekte
MF11	Societe Generale Effekte
MF29	Societe Generale Effekte
MF36	Societe Generale Effekte
MF37	Societe Generale Effekte
MF47	Societe Generale Effekte
MF60	Societe Generale Effekte
MF75	Societe Generale Effekte
MF76	Societe Generale Effekte
MFON	Ojsc Megafon
MFX	Manx Financial Group Plc
MGAM	Morgan Crucible Co Plc
MGGT	Meggitt Plc
MGHC	M & G High Income Investment Trust Plc
MGHI	M & G High Income Investment Trust Plc
MGHP	M & G High Income Investment Trust Plc
MGHU	M & G High Income Investment Trust Plc
MGHZ	M & G High Income Investment Trust Plc
MGII100	Macquarie 1000 Idx
MGNS	Morgan Sindall Group Plc
MGNT	Ojsc Magnit
MGR	Miton Group Plc
MGTL	Lyxor International Asse
MHDU	Source Markets Public Limited Company
MHDX	Source Markets Public Limited Company
MHID	Mahindra & Mahindra Limi
MHM	Marsh & Mclennan Cos. Inc
MHN	Menhaden Capital Plc
MHPC	Mhp S.A
MIBX	Lyxor International Asse
MIDD	Ishares Plc
MIDW	Midwich Group Plc
MIG	Mobeus Income & Growth 2 Vct Plc
MIG1	Maven Income & Growth Vc
MIG2	Maven Income and Growth
MIG3	Maven Income and Growth
MIG4	Mobeus Income & Growth 4
MIG5	Maven Income and Growth
MIG6	Maven Income and Growth
MIGO	Miton Global Opportunities Plc
MIL	Myanmar Investments Inte
MILW	Myanmar Investments Inte
MIN	Minoan Group Plc
MINC	Miton UK Microcap Trust Plc
MINI	Miton UK Microcap Trust
MINT	Pimco Fixed Income Source ETFS Plc
MINV	Ishares Vi Plc (The Comp
MIO	Minco Plc
MIRA	Mirada Plc
MIUSA	Macquarie USA Infrstructure Idx
MIVO	Amundi ETF
MIX	Mobeus Income & Growth Vct Plc
MKLW	Mucklow [A & J] Group Plc
MKS	Marks and Spencer Group Plc
MKT	Market Tech Holdings Lim
MLC	Millennium & Copthorne Hotels Plc
MLD	Mirland Development Corporation Plc
MLIN	Molins Plc
MLPD	Source Markets Public Li
MLPI	Go Ucits ETF Solutions P
MLPP	Source Markets Public Li
MLPQ	Source Markets Public Li
MLPS	Source Markets Public Li
MLPX	Go Ucits ETF Solutions P
MMC	Management Consulting Group Plc
MMH	Marshall Motor Holdings
MMK	Ojsc Magnitogorsk Iron &
MMP	Marwyn Management Partners Plc
MMX	Minds + Machines Group L
MN1X	FTSE Global 100 Index
MNC	Metminco Limited
MNDI	Mondi Plc
MNKS	Monks Investment Trust Plc
MNL	Manchester & London Investment Trust Plc
MNOD	Mmc Norilsk Nickel
MNP	Martin Currie Global Portfolio Trust Plc
MNZS	Menzies[John] Plc
MOAT	Market Vectors Ucits ETFS Plc
MOGP	Mountfield Group Plc
MOLD	Magyar Olaj-Es Gazipare
MONI	Monitise Plc
MONY	Moneysupermarket.Com Group Plc
MORT	Mortice Limited
MOS	Mobile Streams Plc
MOSB	Moss Bros Group Plc
MOTR	Motorpoint Group Plc
MPAP	Source Markets Public Li
MPAY	Mi-Pay Group Plc
MPCE	Source Markets Public Li
MPCX	Source Markets Public Li
MPE	M.P. Evans Group Plc
MPFE	Source Markets Public Li
MPI	Michael Page International Plc
MPM	Mporium Group Plc
MPO	Macau Property Opportunities Fund Limite
MRC	Mercantile Investment Trust [The] Plc
MRCH	Merchants Trust Plc
MRL	Marlowe Holdings Limited
MRO	Melrose Plc
MRS	Management Resource Solu
MRW	Morrison [Wm] Supermarkets Plc
MSED	Lyxor Index Fund
MSEU	Lyxor International Asse
MSEX	Lyxor International Asse
MSG	Milestone Group Plc
MSI	MS International Plc
MSLH	Marshalls Plc
MSMN	Mosman Oil and Gas Limit
MSYS	Microsaic Systems Plc
MTC	Mothercare Plc
MTE	Montanaro European Smaller C. Tst Plc
MTEC	Matchtech Group Plc
MTFB	Motif Bio Plc
MTH	Mithras Investment Trust Plc
MTIX	Multi Units France
MTL	Metals Exploration Plc
MTMY	Matomy Media Group Ltd.
MTO	Mitie Group Plc
MTPH	Midatech Pharma Plc
MTR	Metal Tiger Plc
MTRO	Metro Bank Plc
MTU	Montanaro UK Smaller Companies Investmen
MTVW	Mountview Estates Plc
MTW	Mattioli Woods Plc
MTXX	Multi Units France
MUBL	Mbl Group Plc
MUL	Mulberry Group Plc
MUR	Murgitroyd Group Plc
MUT	Murray Income Trust Plc
MV1X	FTSE Mv Exchanges Index
MVAU	Multi Units France
MVEU	Ishares Vi Plc (The Comp
MVI	Marwyn Value Investors Limited
MVOL	Ishares Vi Plc (The Comp
MVUS	Ishares Vi Plc (The Comp
MVUX	Multi Units France
MWE	Mti Wireless Edge Ltd.
MWG	Modern Water Plc
MWY	Mid-Wynd International Investment Trust
MXCP	Mxc Capital Plc
MXCT	Maxcyte Inc
MXEU	Source Markets Public Li
MXF	Medicx Fund Limited
MXFP	Source Markets Public Li
MXFS	Source Markets Public Limited Company
MXJP	Source Markets Public Limited Company
MXO	Mx Oil Plc
MXUS	Source Markets Public Limited Company
MXWO	Source Markets Public Limited Company
MXWS	Source Markets Public Li
MYI	Murray International Trust Plc
MYIB	Murray International Trust Plc
MYSL	Mysale Group Plc
MYSQ	Mysquar Limited
MYT	Mytrah Energy Limited
MYX	Mycelx Technologies Corporation
N098	Namibia Local Index
N099	Namibia Overall Index
N135	Namibia Chemicals Index
N175	Ftse/Jse Namibia Indust
N177	Namibia Africa Minning I
N272	Namibia Africa Genaral I
N30X	FTSE Norex 30 Index
N30XN	FTSE Nordic 30
N30XU	FTSE Nordic 30 Index (Us
N353	Namibia Beverages Index
N357	Namibia Africa Food Prod
N400	Source Markets Public Li
N453	Ftse/Namibian Overall In
N4US	Source Markets Public Li
N510	Namibia Basic Materials
N520	Namibia Africa Industria
N530	Namibia Consumer Goods I
N533	Namibia Africa Food&Drug
N537	Namibia Africa General R
N540	Ftse/Namibian Overall In
N550	Namibia Consumer Service
N580	Namibia Africa Financial
N835	Namibia Banks Index
N853	Namibia Africa Nonlife I
N857	Namibia Africa Life Insu
N863	Namibia Real Estate Inve
N867	Ftse/Namibian Overall In
N877	Namibia Africa Genaral F
NAH	Nahl Group Plc
NAIT	North American Income Trust [The] Plc
NAK	Nakama Group Plc
NANO	Nanoco Group Plc
NAR	Northamber Plc
NAS	North Atlantic Smaller Companies Investm
NASA	Nasstar Plc
NBB	Norman Broadbent Plc
NBDD	Nb Distressed Debt Investment Fund Limit
NBDG	Nb Distressed Debt Inves
NBDX	Nb Distressed Debt Inves
NBI	Northbridge Industrial Services Plc
NBLS	Nb Global Floating Rate Income Fund Limi
NBLU	Nb Global Floating Rate Income Fund Limi
NBNK	Nbnk Investments Plc
NBPE	Nb Private Equity Partners Limited
NBPZ	Nb Private Equity Partners Limited
NBS	Nationwide Building Society
NBSP	Newcastle Building Society
NCC	Ncc Group Plc
NCCL	Ncondezi Coal Company Limited
NCE	New City Energy Limited
NCON	Norcon Plc
NCSP	Public Joint Stock Compa
NCT	Northcote Energy Limited
NCYF	New City High Yield Fund Limited
NDKX	FTSE Denmark 20 Index
NEP	Neptune-Calculus Income and Growth Vct P
NEPI	New Europe Property Investments Plc
NESF	Nextenergy Solar Fund Li
NET	Netcall Plc
NETD	Netdimensions [Holdings] Limited
NEW	New World Oil and Gas Plc
NEX	National Express Group Plc
NFC	Next Fifteen Communications Group Plc
NFIX	FTSE Finland 25 Index
NG	NATIONAL GRID TRACO ord gbp0.10
NG1Q	National Grid Plc
NG3L	ETFS Commodity Securities Limited
NG3S	ETFS Commodity Securities Limited
NGAF	ETFS Commodity Securities Limited
NGAS	ETFS Commodity Securities Limited
NGL3	Sg Issuer
NGR	Nature Group Plc
NGSP	ETFS Commodity Securities Limited
NHY	Norsk Hydro A.S.A
NICK	ETFS Commodity Securities Limited
NICL	Nichols Plc
NII	New India Investment Trust Plc
NIPT	Premaitha Health Plc
NJXE	Nomura Next Funds Irelan
NJXU	Nomura Next Funds Irelan
NK4E	Ishares II Plc
NKTN	Nektan Plc
NLG	Arria Nlg Plc
NLGOV01	FTSE Netherlands Governm
NLMK	Ojsc Novolipetsk Steel
NMC	Nmc Health Plc
NMD	North Midland Construction Plc
NMG	Noricum Gold Limited
NMIX	FTSE Actuaries 350 [Exit]
NMIXNUK	FTSE 350 Ex Investment T
NMX	FTSE Actuaries 350
NMX0530	FTSE 350 Oil & Gas Produ
NMX0570	FTSE 350 Oil Equipment &
NMX1350	FTSE 350 Chemicals
NMX1730	FTSE 350 Forestry & Pape
NMX1750	FTSE 350 Industrial Meta
NMX1770	FTSE 350 Mining
NMX2350	FTSE 350 Construction &
NMX2710	FTSE 350 Aerospace & Def
NMX2720	FTSE 350 General Industr
NMX2730	FTSE 350 Electronic & El
NMX2750	FTSE 350 Industrial Engi
NMX2770	FTSE 350 Industrial Tran
NMX2790	FTSE 350 Support Service
NMX3350	FTSE 350 Automobiles & P
NMX3530	FTSE 350 Beverages
NMX3570	FTSE 350 Food Producers
NMX3720	FTSE 350 Household Goods
NMX3760	FTSE 350 Personal Goods
NMX3780	FTSE 350 Tobacco
NMX4530	FTSE 350 Health Care Equ
NMX4570	FTSE 350 Pharmaceuticals
NMX5330	FTSE 350 Food & Drug Ret
NMX5370	FTSE 350 General Retaile
NMX5550	FTSE 350 Media
NMX5750	FTSE 350 Travel & Leisur
NMX6530	FTSE 350 Fixed Line Tele
NMX6570	FTSE 350 Mobile Telecomm
NMX7530	FTSE 350 Electricity
NMX7570	FTSE 350 Gas Water & Mul
NMX8350	FTSE 350 Banks
NMX8530	FTSE 350 Nonlife Insuran
NMX8570	FTSE 350 Life Insurance
NMX8630	FTSE 350 Real Estate & I
NMX8670	FTSE 350 Real Estate Inv
NMX8770	FTSE 350 General Financi
NMX8980	FTSE 350 Equity Investme
NMX9530	FTSE 350 Software & Comp
NMX9570	FTSE 350 Technology Hard
NMXDEN	Ftse350Domexpntind
NOG	Nostrum Oil & Gas Plc
NOKP	ETFS Foreign Exchange Limited
NOP	Northern Petroleum Plc
NORD	Nord Gold N.V.
NORWAY30	FTSE Norway 30 Index
NORX	Multi Units France
NOVA	Nova Resources Limited
NPT	Netplay TV Plc
NRGG	Multi Units Luxembourg
NRGW	Multi Units Luxembourg
NRI	Northern Investors Company Plc
NRR	Newriver Retail Limited
NRRP	North River Resources Plc
NSA	Nimrod Sea Assets Limite
NSCI	Netscientific Plc
NSF	Non-Standard Finance Plc
NSHREACN	FTSE China N Share All C
NSI	New Star Investment Trust Plc
NSIX	FTSE Actuaries Fledgling [Exit]
NSWX	FTSE Sweden 30 Index
NSX	FTSE Actuaries Fledgling
NTA	Northacre Plc
NTBR	Northern Bear Plc
NTEA	Northern Electric Plc
NTG	Northgate Plc
NTLG	New Trend Lifestyle Group Plc
NTN	Northern 3 Vct Plc
NTOG	Nostra Terra Oil and Gas Company Plc
NTQ	Enteq Upstream Plc
NTV	Northern 2 Vct Plc
NUM	Numis Corporation Plc
NUOG	Nu-Oil and Gas Plc
NVA	Novae Group Plc
NVT	Northern Venture Trust Plc
NVTK	Oao Novatek
NWBD	National Westminster Bank Plc
NWF	Nwf Group Plc
NWR	New World Resources Plc
NWT	Newmark Security Plc
NXKE	Nomura Next Funds Irelan
NXKU	Nomura Next Funds Irelan
NXR	Norcros Plc
NXT	Next Plc
NYO	Nyota Minerals Ld
NZDP	ETFS Foreign Exchange Limited
NZGB	ETFS Foreign Exchange Limited
O006	Ishares Plc
O011	Ishares Plc
O012	Ishares Plc
O025	Ishares Plc
O026	Ishares Plc
O033	Ishares Plc
O034	Ishares Plc
O041	Ishares Plc
O061	Ishares Plc
O120	Ishares Plc
OAP3	Octopus Apollo Vct Plc
OAPD	Octopus Apollo Vct Plc
OBT	Obtala Resources Limited
OCDO	Ocado Group Plc
OCL	Oakley Capital Investments Limited
OCN	Ocean Wilsons [Holdings] Ld
OCT	Octagonal Plc
ODX	Omega Diagnostics Group Plc
OEC1	Octopus Eclipse Vct Plc
OEX	Oilex Ld
OGDC	Oil and Gas Development
OGN	Origin Enterprises Plc
OGZD	Oao Gazprom
OIG	Oryx International Growth Fund Ltd
OILB	ETFS Oil Securities Ld
OILD	UBS Ag
OILE	UBS Ag
OILL	UBS Ag
OILW	ETFS Oil Securities Ld
OKEY	O'Key Group S.A.
OLBP	ETFS Oil Securities Ld
OLWP	ETFS Oil Securities Ld
OMG	Omg Plc
OMI	Orosur Mining Inc
OMIP	One Media Ip Group Plc
OML	Old Mutual Plc
ONC	Oncimmune Holdings Plc
ONEV	Oneview Group Plc
ONL	On-Line Plc
ONZ	Onzima Ventures
OOA	Octopus Aim Vct Plc
OPG	Opg Power Ventures Plc
OPHR	Ophir Energy Plc
OPM	1Pm Plc
OPRA	Opera Investments Plc
OPTI	Optibiotix Health Plc
ORCH	Orchard Funding Group Pl
ORCP	Oracle Coalfields Plc
ORE	Orogen Gold Plc
ORM	Ormonde Mining Plc
OSB	Onesavings Bank Plc
OSB1	ETFS Oil Securities Limi
OSB2	ETFS Oil Securities Limi
OSB3	ETFS Oil Securities Limi
OSEC	Octopus Second Aim Vct Plc
OSI	Osirium Technologies Plc
OSU	Orsu Metals Corporation
OSW1	ETFS Oil Securities Limi
OSW2	ETFS Oil Securities Limi
OSW3	ETFS Oil Securities Limi
OTB	On The Beach Group Plc
OTC	Ortac Resources Limited
OTM	Ottoman Fund Limited [The]
OTMT	Orascom Telecom Media An
OTPD	Otp Bank Plc
OTT	Oxford Technology 3 Venture Capital Trus
OTV2	Octopus Titan Vct Plc
OUT	Outsourcery Plc
OVG	Ovoca Gold Plc
OXB	Oxford Biomedica Plc
OXF	Oxford Technology 4 Venture Capital Trus
OXIG	Oxford Instruments Plc
OXP	Oxford Pharmascience Group Plc
OXT	Oxford Technology Venture Capital Trust
P2P	P2P Global Investments P
PAA	Parallel Media Group Plc
PAC	Pacific Assets Trust Plc
PACL	Pacific Alliance China Land Limited
PADV	SSGA SPDR ETFS Europe I
PAF	Pan African Resources Plc
PAG	Paragon Group of Companies Plc
PAG1	Paragon Group of Compani
PAG2	Paragon Group of Compani
PAG3	Paragon Group of Compani
PAGR	ETFS Hedged Commodity Securities Limited
PAL	Equatorial Palm Oil Plc
PALL	ETFS Hedged Commodity Securities Limited
PANR	Pantheon Resources Plc
PAY	Paypoint Plc
PAYS	Paysafe Group Plc
PBRT	ETFS Hedged Commodity Securities Limited
PBUL	ETFS Hedged Commodity Securities Limited
PCA	Palace Capital Plc
PCF	Private & Commercial Finance Group Plc
PCFS	Polar Capital Global Fin
PCFT	Polar Capital Global Fin
PCGE	Pcg Entertainment Plc
PCGH	Polar Cap Glbl Health Gwth&Inc Tst Plc
PCOP	ETFS Hedged Commodity Securities Limited
PCRD	ETFS Hedged Commodity Securities Limited
PCT	Polar Capital Technology Trust Plc
PCTN	Picton Property Income Ld
PCTZ	Picton Zdp Limited
PDG	Pendragon Plc
PDL	Petra Diamonds Limited
PDZ	Prairie Mining Limited
PEBI	Port Erin Biopharma Investments Limited
PEG	Petards Group Plc
PEL	Paragon Entertainment Limited
PEN	Pennant International Group Plc
PENR	ETFS Hedged Commodity Securities Limited
PEQ	Private Equity Investor Plc
PET	Petrel Resources Plc
PETS	Pets At Home Group Plc
PEW	Premier Energy & Water Trust Plc
PEY	Princess Private Equity Holding Limited
PEZ	Pewt Securities 2020 Plc
PF16	Provident Financial Plc
PF17	Provident Financial Plc
PF21	Provident Financial Plc
PFAG	ETFS Hedged Commodity Securities Limited
PFAND01	FTSE Pfandbrief Total Pr
PFAND03	FTSE Pfandbrief Price In
PFAND05	FTSE Pfandbrief Price In
PFAND07	FTSE Pfandbrief Price In
PFAND10	FTSE Pfandbrief Price In
PFAND30	FTSE Pfandbrief Price In
PFC	Petrofac Limited
PFD	Premier Foods Plc
PFEN	ETFS Hedged Commodity Securities Limited
PFG	Provident Financial Plc
PFG7	Provident Financial Plc
PFL	Premier Farnell Plc
PFLB	Premier Farnell Plc
PFP	Pathfinder Minerals Plc
PFP1	Places For People Capita
PFP5	Places For People Capita
PFZ	Pfizer Incorporated
PGD	Patagonia Gold Plc
PGH	Personal Group Holdings Plc
PGOO	Proven Growth & Income Vct Plc
PGY	Progility Plc
PHAG	ETFS Metal Securities Ld
PHAU	ETFS Metal Securities Limited
PHC	Plant Health Care Plc
PHD	Proactis Holdings Plc
PHE	Powerhouse Energy Group Plc
PHGP	ETFS Metal Securities Ld
PHI	Pacific Horizon Investment Trust Plc
PHNX	Phoenix Group Holdings
PHO	Peel Hotels Plc
PHOR	Ojsc Phosagro
PHP	Primary Health Properties Plc
PHP1	Primary Health Propertie
PHPD	ETFS Metal Securities Ld
PHPM	ETFS Metal Securities Ld
PHPP	ETFS Metal Securities Ld
PHPT	ETFS Metal Securities Ld
PHSC	Phsc Plc
PHSP	ETFS Metal Securities Ld
PHST	Ojsc Pharmstandard
PHTM	Photo-Me International Plc
PIER	Brighton Pier Group Plc (The)
PIK	Pik Group
PIL	Produce Investments Plc
PILR	Pacific Industrial & Logistics REIT Plc
PIM	Plant Impact Plc
PIMT	ETFS Hedged Commodity Securities Limited
PIN	Pantheon International Participations Pl
PINN	Pinnacle Technology Group Plc
PINR	Pantheon International Participations Pl
PIP	Pipehawk Plc
PIRI	Pires Investments Plc
PJF	Prospect Japan Fund Ld
PKG	Park Group Plc
PLA	Plastics Capital Plc
PLAZ	Plaza Centers N.V.
PLI	Perpetual Income and Growth Investment T
PLMO	Polemos Plc
PLND	Poundland Group Plc
PLP	Polypipe Group Plc
PLTM	ETFS Commodity Securities Limited
PLUS	Plus500 Ltd
PMEA	Pme African Infrastructure Opportunities
PMG	Parkmead Group [The] Plc
PML	Papua Mining Plc
PMO	Premier Oil Plc
PMO1	Premier Oil Plc
PMP	Portmeirion Group Plc
PMR	Panmure Gordon & Co. Plc
PNA	Penna Consulting Plc
PNGA	ETFS Hedged Commodity Securities Limited
PNL	Personal Assets Trust Plc
PNN	Pennon Group Plc
PNS	Panther Securities Plc
POB	Nationwide Building Society
POBA	Nationwide Building Society
POG	Petropavlovsk Plc
POL	Polo Resources Limited
POLR	Polar Capital Holdings Plc
POLY	Polymetal International Plc
POS	Plexus Holdings Plc
POWR	Powerflute Oyj
PPB	Paddy Power Betfair Plc
PPC	President Petroleum Company Plc
PPG	Plutus Powergen Plc
PPH	Pphe Hotel Group Limited
PPIX	Prophotonix Limited
PPMT	ETFS Hedged Commodity Securities Limited
PPS	Proton Power Systems Plc
PREC	UBS Ag
PREM	Premier African Minerals
PRES	Pressure Technologies Plc
PRM	Proteome Sciences Plc
PROG	Pro Global Insurance Sol
PROJ	Project Finance Investments Ltd
PROX	Proxama Plc
PRP	Prime People Plc
PRS	Paternoster Resources Plc
PRSM	Blue Prism Group Plc
PRTC	Puretech Health Plc
PRU	Prudential Plc
PRUD	Prudential Plc
PRV	Porvair Plc
PSBW	Powershares Glbal Funds Ireland Plc Powershares
PSDL	Phoenix Spree Deutschlan
PSES	Powershares Glbal Funds Ireland Plc
PSGA	Powershares Glbal Funds Ireland Plc
PSHO	Powershares Glbal Funds Ireland Plc
PSL	Photonstar Led Group Plc
PSN	Persimmon Plc
PSON	Pearson Plc
PSPI	Public Service Properties Investments Li
PSRE	Powershares Glbal Funds Ireland Plc
PSRF	Powershares Glbal Funds Ireland Plc
PSRM	Powershares Glbal Funds Ireland Plc
PSRU	Powershares Glbal Funds Ireland Plc
PSRW	Powershares Glbal Funds Ireland Plc
PSSP	Powershares Glbal Funds Ireland Plc
PSVR	ETFS Hedged Commodity Securities Limited
PSWC	Powershares Glbal Funds Ireland Plc
PTCM	Porta Communications Plc
PTD	Pittards Plc
PTEC	Playtech Limited
PTF	Phaunos Timber Fund Limited
PTGOV01	FTSE Portugal Government
PTO	Publishing Technology Plc
PTR	Petroneft Resources Plc
PTSG	Premier Technical Servic
PTY	Parity Group Plc
PUB	Punch Taverns Plc
PURE	Purecircle Limited
PURI	Puricore Plc
PURP	Purplebricks Group Plc
PUS3	ETFS Foreign Exchange Li
PUS5	ETFS Foreign Exchange Limited
PVCS	Pv Crystalox Solar Plc
PVG	Premier Veterinary Group
PVN	Proven Vct Plc
PWS	Pinewood Shepperton Plc
PXOG	Prospex Oil and Gas Plc
PXS	Provexis Plc
PYC	Physiomics Plc
PZC	Pz Cussons Plc
QDII1	Ftse/Xinhua Hong Kong In
QDII2	Ftse/Xinhua Hong Kong In
QDIV	Ishares II Plc
QFI	Quadrise Fuels International Plc
QIF	Qatar Investment Fund Plc
QP	Quantum Pharma
QQ	qinetiq group ord gbp0
QQQ3	Boost Issuer Public Limi
QQQS	Boost Issuer Public Limi
QRT	Quarto Group Incorporated
QTX	Quartix Holdings Plc
QUID	Pimco Fixed Income Source ETFS Plc
QXT	Quixant Plc
R0UK	FTSE E/N Deexukcap
R1CPF	Russell 1000 Comprehensive Factor Index
R1LB	Russell 1000 Low Beta Equal Weight Index
R1MFF	Russell 1000 Momentum Focused Factor Ind
R1MFFR	Russell 1000 Momentum Focused Factor Net
R1VFF	Russell 1000 Low Volatility Focused Fact
R1VFFR	Russell 1000 Low Volatility Focused Fact
R1YFF	Russell 1000 Yield Focused Factor Index
R1YFFR	Russell 1000 Yield Focused Factor Net Ta
R2SC	SSGA SPDR ETFS Europe II
R2US	SSGA SPDR ETFS Europe II
R3TM	SSGA SPDR ETFS Europe II
R4E	Reach4Entertainment Ente
RAME	Rame Energy Plc
RAT	Rathbone Brothers Plc
RB	Reckitt Benckiser
RB51	Royal Bank of Scotland P
RB81	Royal Bank of Scotland P
RBD	Reabold Resources Plc
RBG	Revolution Bars Group Pl
RBLI	Royal Bank of Scotland Plc
RBN	Robinson Plc
RBPI	Royal Bank of Scotland Plc
RBPX	Royal Bank of Scotland Plc
RBRP	Royal Bank of Scotland Plc
RBS	Royal Bank of Scotland Group Plc
RC2	Reconstruction Capital I
RCDO	Ricardo Plc
RCHA	Rothschilds Continuation Finance [C.I.]
RCI	Rapidcloud International
RCN	Redcentric Plc
RCP	Rit Capital Partners Plc
RDI	Redefine International P.L.C.
RDL	Ranger Direct Lending Fu
RDSA	Royal Dutch Shell Plc
RDSB	Royal Dutch Shell Plc
RDT	Rosslyn Data Technologie
RDW	Redrow Plc
RDXS	Source Markets Public Limited Company
RE	R.e.a. Holdings
RE.B	R.E.A. Holdings Plc
REAC	React Energy Plc
REAT	React Group Plc
REC	Record Plc
RECI	Real Estate Credit Investments Pcc Limit
RECP	Real Estate Credit Investments Pcc Limit
RED	Redt Energy Plc
REDD	Redde Plc
REDT	Red24 Plc
REDX	Redx Pharma Plc
REL	Reed Elsevier Plc
REM	Rare Earth Minerals Plc
RENE	Reneuron Group Plc
REVO	Revolymer Plc
REX	Rexam Plc
RGD	The Real Good Food Company Plc
RGL	Regional REIT Limited
RGM	Regency Mines Plc
RGP	Ross Group Plc
RGU	Regus Plc
RHL	Redhall Group Plc
RIC	Richoux Group Plc
RICA	Ruffer Investment Company Ltd
RICO	Ricoh Co Ltd
RIFS	Reliance Infrastructure
RIGD	Reliance Industries Limi
RIIC	Rights & Issues Investment Trust Plc
RIII	Rights & Issues Investment Trust Plc
RIO	Rio Tinto Plc
RIOB	FTSE Russia Iob Index
RIOL	Lyxor International Asse
RIOU	Lyxor International Asse
RIV	River and Mercantile Gro
RKH	Rockhopper Exploration Plc
RKMD	Ojsc Rostelecom
RLD	Richland Resources Ltd
RLE	Real Estate Investors Plc
RLH	Red Leopard Holdings Plc
RM	RM Plc
RM2	Rm2 International S.A.
RM38	Royal Bank of Scotland P
RMA	Rasmala Plc
RMG	Royal Mail Plc
RMM	Rambler Metals & Mining Plc
RMMC	River and Mercantile UK
RMP	Red Emperor Resources NL
RMV	Rightmove Plc
RNK	Rank Group Plc
RNO	Renold Plc
RNWH	Renew Holdings Plc
RNXGUS	FTSE  Epra/Nareit Global
ROBE	Go Ucits ETF Solutions P
ROBG	Go Ucits ETF Solutions P
ROBO	Go Ucits ETF Solutions P
ROL	Rotala Plc
ROR	Rotork Plc
ROSE	Rose Petroleum Plc
ROSN	Ojsc Oc Rosneft
RPC	RPC Group Plc
RPO	Ruspetro Plc
RPS	Rps Group Plc
RPT	Regal Petroleum Plc
RQFI	DB X-Trackers
RQIH	Randall & Quilter Investment Holdings Pl
RR	Rolls Royce Group
RRE	Rockrose Energy Plc
RRL	Range Resources Limited
RRR	Red Rock Resources Plc
RRS	Randgold Resources Ld
RS2U	Amundi ETF
RS68	Royal Bank of Scotland P
RS72	Royal Bank of Scotland P
RS82	Royal Bank of Scotland P
RS98	Royal Bank of Scotland P
RSA	Rsa Insurance Group Plc
RSAB	Rsa Insurance Group Plc
RSE	Riverstone Energy Limite
RSGL	Lyxor International Asse
RSS	Rab Special Situations Company Limited
RST	Restore Plc
RSTR	Rightster Group Plc
RSW	Renishaw Plc
RT26	Royal Bank of Scotland P
RT40	Royal Bank of Scotland P
RT82	Royal Bank of Scotland P
RTC	Rtc Group Plc
RTN	Restaurant Group Plc
RTO	Rentokil Initial Plc
RTWO	Etfx Fund Company Plc
RTWP	Etfx Fund Company Plc
RTYS	Source Markets Public Limited Company
RU13	Royal Bank of Scotland P
RU2K	Lyxor International Asse
RUR	Rurelec Plc
RUS	Raven Russia Ltd
RUSG	Lyxor International Asse
RUSL	Lyxor International Asse
RUSP	Raven Russia Ltd
RUSU	Lyxor International Asse
RUSV	Lyxor International Asse
RUSW	Raven Russia Ltd
RWA	Robert Walters Plc
RWS	Rws Holdings Plc
RXB	Rex Bionics Plc
RXP	Roxi Petroleum Plc
RYA	Ryanair Holdings Plc
S100	Source Markets Public Li
S250	Source Markets Public Li
S32	South32 Limited
S400	Source Markets Public Li
S600	Source Markets Public Li
S6EW	Ossiam Lux
S7XP	Source Markets Public Li
SAA	M&C Saatchi Plc
SAAA	Ishares Vi Plc (The Comp
SAB	Sabmiller Plc
SAC	Sacoil Holdings Limited
SAD	ETFS Foreign Exchange Limited
SAF	Safeland Plc
SAFE	Safestore Holdings Plc
SAG	Sagentia Group Plc
SAGA	Saga Plc
SAGR	ETFS Commodity Securities Limited
SAL	Spaceandpeople Plc
SALL	ETFS Commodity Securities Limited
SALU	ETFS Commodity Securities Limited
SALV	Salvarx Group Plc
SAN	Santander UK Plc
SANB	Santander UK Plc
SAP3	ETFS Foreign Exchange Li
SAPO	South African Property Opportunities Plc
SAR	Sareum Holdings Plc
SAT	Satellite Solutions Worl
SAU3	ETFS Foreign Exchange Li
SAUP	ETFS Foreign Exchange Limited
SAUS	Ishares III Plc
SAV	Savannah Resources Plc
SBEG	UBS ETF
SBEM	UBS ETF
SBER	Sberbank of Russia
SBID	State Bank of India
SBIO	Source Markets Public Li
SBLM	Sable Mining Africa Ld
SBRT	ETFS Commodity Securities Limited
SBRY	Sainsbury [J] Plc
SBS	Source Bioscience Plc
SBSB	Skipton Building Society
SBUL	ETFS Commodity Securities Limited
SBUY	Powershares Glbal Funds
SCAD	ETFS Foreign Exchange Limited
SCAM	Scottish American Investment Co. Plc
SCDN	FTSE Developed Small Cap
SCDNCH	FTSE Small Cap Net Chf I
SCDNEU	FTSE Small Cap Net EUR I
SCDNUK	FTSE Small Cap Net Gbp I
SCDP	ETFS Foreign Exchange Limited
SCE	Surface Transforms Plc
SCF	Schroder Income Growth Fund Plc
SCFE	ETFS Commodity Securities Limited
SCH	Safecharge International
SCHF	ETFS Foreign Exchange Limited
SCHO	Scholium Group Plc
SCHP	ETFS Foreign Exchange Limited
SCIN	Scottish Investment Trust Plc
SCL	Schlumberger Ld
SCLP	Scancell Holdings Plc
SCNY	ETFS Foreign Exchange Limited
SCOC	ETFS Commodity Securities Limited
SCOM	ETFS Foreign Exchange Li
SCOP	ETFS Commodity Securities Limited
SCOV	Ishares III Plc
SCP	Schroder UK Mid Cap Fund Plc
SCPA	Scapa Group Plc
SCS	Scs Group Plc
SCT	Softcat Plc
SCTO	ETFS Commodity Securities Limited
SCYP	ETFS Foreign Exchange Limited
SD12	FTSE Dev Small Cap Ex No
SD13	FTSE Dev Europe Small CA
SD22	Sga Societe Generale Acc
SD64	Sga Societe Generale Acc
SDEU	Ishares V Public Limited Company
SDHG	Ishares IV Plc
SDHY	Ishares IV Plc
SDI	Scientific Digital Imaging Plc
SDIG	Ishares IV Plc
SDL	Sdl Plc
SDM	Stadium Group Plc
SDP	Schroder Asiapacific Fund Plc
SDR	Schroders Plc
SDRC	Schroders Plc
SDU	Schroder UK Growth Fund Plc
SDV	Small Companies Dividend Trust Plc
SDVZ	Small Companies Zdp Plc
SDX	Sdx Business Systems
SDY	Speedy Hire Plc
SE15	Ishares III Plc
SE87	Sga Societe Generale Acc
SEA	Seaenergy Plc
SEAG	Ishares III Plc
SEC	Strategic Equity Capital Plc
SEDY	Ishares V Public Limited Company
SEE	Seeing Machines Limited
SEGA	Ishares III Plc
SEMA	Ishares III Plc
SEMB	Ishares II Plc
SEMH	SSGA SPDR ETFS Europe II
SEML	Ishares III Plc
SEMS	Ishares III Plc
SEN	Senterra Energy Plc
SEP	Standard Life European Private Equity TR
SEPL	Seplat Petroleum Develop
SEPU	Sepura Plc
SEQI	Sequoia Economic Infrast
SERE	Schroder European Real Estate Investment
SERV	Servelec Group Plc
SESP	Ishares V Public Limited Company
SEU3	ETFS Foreign Exchange Li
SEU5	Sg Issuer
SEUC	SSGA SPDR ETFS Europe I
SEUP	ETFS Foreign Exchange Limited
SEUR	ETFS Foreign Exchange Limited
SEV	Servision Plc
SEY	Sterling Energy Plc
SF05	Sga Societe Generale Acc
SF06	Sga Societe Generale Acc
SF47	Sga Societe Generale Acc
SF99	Sga Societe Generale Acc
SFE	Safestyle UK Plc
SFR	Severfield-Rowen Plc
SFRB	Ishares V Public Limited Company
SG05	Sga Societe Generale Acc
SG06	Sg Issuer
SG17	Sg Issuer
SG18	Sg Issuer
SG21	SOCIETE GENERALE ACCEPTANCE NV PROT ACCELTOR CERT 2/2/12 EPEZ E1 EUR0 C
SG23	SOCIETE GENERALE ACCEPTANCE NV IDX CERT 07/11/12(EUROSTOXX 50)GBP4004
SG27	SOCIETE GENERALE ACCEPTANCE NV CERT 03/01/10BEAR E1 USD0 C
SG29	SOCIETE GENERALE ACCEPTANCE NV ENH H/YLD CERT 30/07/08 BARC E1 GBX0 C
SG30	SOCIETE GENERALE ACCEPTANCE NV PROTD ACC CERT 20/03/13(WORLD TIMBER)USD
SG32	SOCIETE GENERALE ACCEPTANCE NV CERT 24/10/08 TREI E1 GBX C
SG35	SOCIETE GENERALE ACCEPTANCE NV PROT ACCLR CERT 13/6/12SX50 E1 EUR4500 C
SG41	SOCIETE GENERALE ACCEPTANCE NV CERT 5/9/08(GLOBL IDX AUTOCALL) GBP E1 C
SGAS	ETFS Commodity Securities Limited
SGB3	ETFS Foreign Exchange Li
SGB5	Sg Issuer
SGBB	ETFS Foreign Exchange Li
SGBP	ETFS Foreign Exchange Limited
SGBS	ETFS Metal Securities Ld
SGC	Stagecoach Group Plc
SGCC	Ishares III Plc
SGE	Sage Group Plc
SGEA	Ishares III Plc
SGGD	Ojsc Surgutneftegas
SGH1	Sga Societe Generale Acc
SGI	Stanley Gibbons Group Plc
SGIL	Ishares III Plc
SGLD	Source Physical Markets Plc
SGLN	Ishares Physical Metals Plc
SGLO	Ishares III Plc
SGLP	Source Physical Markets Plc
SGM	Sigma Capital Group Plc
SGP	Supergroup Plc
SGQD	Multi Units Luxembourg
SGQE	Multi Units Luxembourg
SGQL	Multi Units Luxembourg
SGQP	Multi Units Luxembourg
SGQX	Multi Units Luxembourg
SGR	Shore Capital Group Limited
SGRA	ETFS Commodity Securities Limited
SGRE	Schroder Global Real Est
SGRO	Segro Plc
SGS100	FTSE SGX Asia Shariah 10
SGVB	Lyxor Index Fund
SGVL	Lyxor Index Fund
SGZ	Scotgold Resources Limited
SHAW	Shawbrook Group Plc
SHB	Shaftesbury Plc
SHEA	ETFS Commodity Securities Limited
SHG	Shanta Gold Limited
SHI	Sig Plc
SHOE	Shoe Zone Plc
SHP	Shire Plc
SHRE	Share Plc
SHRS	Shires Income Plc
SHYG	Ishares Plc
SHYU	Ishares II Plc
SI3L	ETFS Commodity Securities Limited
SI3S	ETFS Commodity Securities Limited
SIA	Soco International Plc
SIGB	Sherborne Investors (Gue
SIGT	Seneca Global Income & G
SIHL	Symphony International Holdings Ld
SILG	UBS Ag
SIM	Simigon Ltd.
SIME	ETFS Commodity Securities Limited
SIPP	Hotel Corp.
SIR	Secure Income REIT Plc
SIS	Science In Sport Plc
SIT	Sanditon Investment Trus
SITB	Ishares V Public Limited Company
SIV	St. Ives Plc
SIXH	600 Group Plc
SJG	Schroder Japan Growth Fund Plc
SJNK	SSGA SPDR ETFS Europe I
SJP3	ETFS Foreign Exchange Li
SJP5	Sg Issuer
SJPA	Ishares III Plc
SJPN	FTSE Shariah Japan 100 Index
SJPNU	FTSE Japan 100 Shariah Index USD
SJPP	ETFS Foreign Exchange Limited
SJPY	ETFS Foreign Exchange Limited
SKG	Smurfit Kappa Group Plc
SKGB	ETFS Foreign Exchange Limited
SKMD	Sk Telecom Co Ld
SKP	Skyepharma Plc
SKS	Shanks Group Plc
SKY	British Sky Broadcasting
SL	STANDARD LIFE PLC ORD GBP0.10
SL05	Sga Societe Generale Acc
SL06	Sga Societe Generale Acc
SL15	Sga Societe Generale Acc
SL16	Sga Societe Generale Acc
SL21	Sga Societe Generale Acc
SL29	Sga Societe Generale Acc
SL35	SOCIETE GENERALE ACCEPTANCE NV CALL WTS 18/06/10(HANG SENG)HKD10000
SL36	SOCIETE GENERALE ACCEPTANCE NV CALL WTS 17/12/10(HANG SENG)HKD11000
SL37	SOCIETE GENERALE ACCEPTANCE NV PUT WTS 18/06/10(HANG SENG)HKD8000
SL38	SOCIETE GENERALE ACCEPTANCE NV PUT WTS 17/12/10(HANG SENG)HKD7000
SL46	SOCIETE GENERALE ACCEPTANCE NV CALL WTS 19/12/08 BARC E1 GBX800 C
SL47	SOCIETE GENERALE ACCEPTANCE NV PUT WTS 20/6/08 BARC E1 GBX600 C
SL52	SOCIETE GENERALE ACCEPTANCE NV CALL WTS 20/6/08 F100 E0.001 GBP6500 C
SLCT	ETFS Commodity Securities Limited
SLED	Lebanese Company For The
SLES	Standard Life Equity Income Trust Plc
SLET	Standard Life Equity Income Trust Plc
SLI	Standard Life Investments Property Incom
SLN	Silence Therapeutics Plc
SLNG	Slingsby [H.C.] Plc
SLP	Sylvania Platinum Limited
SLQJPLL2	FTSE Japan Large Cap Sup
SLQJPLL3	FTSE Japan Large Cap Sup
SLQJPLS1	FTSE Japan Large Cap Sup
SLQJPLS2	FTSE Japan Large Cap Sup
SLQJPLS3	FTSE Japan Large Cap Sup
SLQSPL2X	FTSE Spain Super Liquid
SLQSPL3X	FTSE Spain Super Liquid
SLQSPS1X	FTSE Spain Super Liquid
SLQSPS2X	FTSE Spain Super Liquid
SLQSPS3X	FTSE Spain Super Liquid
SLQUKML2	FTSE UK Mid Cap Super Li
SLQUKML3	FTSE UK Mid Cap Super Li
SLQUKML4	FTSE UK Mid Cap Super Li
SLQUKMS1	FTSE UK Mid Cap Super Li
SLQUKMS2	FTSE UK Mid Cap Super Li
SLQUKMS3	FTSE UK Mid Cap Super Li
SLQUSL2	FTSE USA Large Cap Super
SLQUSL3	FTSE USA Large Cap Super
SLQUSL4	FTSE USA Large Cap Super
SLQUSS1	FTSE USA Large Cap Super
SLQUSS2	FTSE USA Large Cap Super
SLQUSS3	FTSE USA Large Cap Super
SLS	Standard Life UK Smaller Companies Trust
SLSC	Standard Life UK Smaller Companies Trust
SLVR	ETFS Commodity Securities Limited
SLXX	Ishares Plc
SM46	Sga Societe Generale Acc
SMA	Sovereign Mines of Africa Plc
SMDS	Smith [Ds] Plc
SMEA	Ishares III Plc
SMIF	Twentyfour Select Monthl
SMIN	Smiths Group Plc
SMJ	Smart [J.] & Co. [Contractors] Plc
SML	Strategic Minerals Plc
SMN1	Shariah Multinationals 1
SMP	St.Modwen Properties Plc
SMP1	St.Modwen Properties Plc
SMRG	Amundi ETF
SMRU	Amundi ETF
SMS	Smart Metering Systems Plc
SMSD	Samsung Electronics Co L
SMSN	Samsung Electronics Co L
SMT	Scottish Mortgage Investment Trust Plc
SMTC	Lyxor Index Fund
SMTG	Summit Germany Limited
SMWH	Wh Smith Plc
SMX	FTSE Smallcap
SMXX	FTSE Smallcap [Exit]
SN	Smith & Nephew
SNAK	Snacktime Plc
SND	Sanderson Group Plc
SNG	Synairgen Plc
SNGA	ETFS Commodity Securities Limited
SNGR	Societatea Nationala De
SNIK	ETFS Commodity Securities Limited
SNN	Sanne Group Plc
SNR	Senior Plc
SNRG	ETFS Commodity Securities Limited
SNT	Sabien Technology Group Plc
SNTY	Synety Group Plc
SNX	Synectics Plc
SNZP	ETFS Foreign Exchange Limited
SO4	Salt Lake Potash Limited
SOG	Statpro Group Plc
SOI	Schroder Oriental Income Fund Limited
SOIL	ETFS Commodity Securities Limited
SOLG	Solgold Plc
SOLI	Solid State Plc
SOLO	Solo Oil Plc
SOM	Somero Enterprise Inc.
SOPH	Sophos Group Plc
SOU	Sound Oil Plc
SOYB	ETFS Commodity Securities Limited
SOYO	ETFS Commodity Securities Limited
SPA	1Spatial Plc
SPAG	Ishares V Public Limited Company
SPAL	Source Physical Markets Plc
SPAP	Source Physical Markets
SPD	Sports Direct International Plc
SPDI	Spdi Secure Property Dev
SPDM	Ishares Physical Metals Plc
SPE	Sopheon Plc
SPET	ETFS Commodity Securities Limited
SPGH	Superglass Holdings Plc
SPGP	Ishares V Public Limited Company
SPH	Sinclair Is Pharma Plc
SPHR	Sphere Medical Holding Plc
SPI	Spire Healthcare Group P
SPI4	Sg Issuer
SPL	Skil Ports & Logistics Limited
SPLA	ETFS Commodity Securities Limited
SPLT	Ishares Physical Metals Plc
SPMT	ETFS Commodity Securities Limited
SPMV	Ishares Vi Plc (The Comp
SPO	Sportech Plc
SPOG	Ishares V Public Limited Company
SPOL	Ishares V Public Limited Company
SPPC	ST Peter Port Capital Limited
SPPP	Source Physical Markets
SPPT	Source Physical Markets Plc
SPRP	Sprue Aegis Plc
SPSY	Spectra Systems Corporation
SPT	Spirent Communications Plc
SPVG	Powershares Glbal Funds
SPX	Spirax-Sarco Engineering Plc
SPX5	SSGA SPDR ETFS Europe I
SPX6	Sga Societe Generale Acc
SPXJ	Ishares III Plc
SPXP	Source Markets Public Li
SPXS	Source Markets Public Limited Company
SPY4	SSGA SPDR ETFS Europe I
SPY5	SSGA SPDR ETFS Europe I
SQN	Sqn Asset Finance Income
SQNC	Sqn Asset Finance Income Fund Limited
SQS	Sqs Software Quality Systems Ag
SQZ	Serica Energy Plc
SRB	Serabi Gold Plc
SRE	Sirius Real Estate Ld
SREI	Schroder Real Estate Investment Trust Li
SRES	Sunrise Resources Plc
SRO	Spitfire Oil Limited
SRP	Serco Group Plc
SRSA	Ishares III Plc
SRSP	Sirius Petroleum Plc
SRT	Software Radio Technology Plc
SRX	Sierra Rutile Limited
SS03	FTSE Global Small Cap Ex
SS07	FTSE Europe Small Cap In
SS08	FTSE Europe Small Cap Ex
SS09	FTSE Asia Pacific Small
SSA	Sistema Jsfc
SSAC	Ishares V Public Limited Company
SSE	Sse Plc
SSHY	Pimco Fixed Income Sourc
SSIL	ETFS Commodity Securities Limited
SSLN	Ishares Physical Metals Plc
SSLV	Source Physical Markets Plc
SSOB	ETFS Commodity Securities Limited
SSPG	Ssp Group Plc
SST	Scottish Oriental Smaller Companies Trus
SSTY	Safestay Plc
SSUG	ETFS Commodity Securities Limited
SSXF	Ishares III Plc
SSY	Scisys Plc
SSYO	ETFS Commodity Securities Limited
STAB	Standard Chartered Plc
STAC	Standard Chartered Plc
STAF	Staffline Group Plc
STAG	Multi Units Luxembourg
STAN	Standard Chartered Plc
STAR	Starcom Plc
STAW	Multi Units Luxembourg
STB	Secure Trust Bank Plc
STCK	Stock Spirits Group Plc
STCM	Steppe Cement Ltd
STEL	Stellar Diamonds Plc
STG	Stellar Resources Plc
STGR	Stratmin Global Resources Plc
STHE	Pimco Fixed Income Sourc
STHR	Sthree Plc
STHS	Pimco Fixed Income Source ETFS Plc
STHY	Pimco Fixed Income Source ETFS Plc
STI	Stratex International Plc
STIM	ETFS Commodity Securities Limited
STJ	St. James's Place Plc
STL	Stilo International Plc
STM	Stm Group PC
STOB	Stobart Group Ld
STR	Stride Gaming Plc
STS	Securities Trust of Scotland Plc
STVG	Stv Group Plc
STX	Shield Therapeutics Plc
STXW	Shield Therapeutics Plc
STY	Styles & Wood Group Plc
STYC	Pimco Fixed Income Sourc
SUAG	Ishares II Plc
SUBX	Subex Limited
SUD5	ETFS Foreign Exchange Limited
SUGA	ETFS Commodity Securities Limited
SUGG	UBS Ag
SUH	Sutton Harbour Holdings Plc
SUK1	Boost Issuer Public Limi
SUK2	Go Ucits ETF Solutions P
SUKC	SSGA SPDR ETFS Europe II
SULA	Sula Iron & Gold Plc
SUMM	Summit Corporation Plc
SUN	Surgical Innovations Group Plc
SUP3	ETFS Foreign Exchange Li
SUP5	ETFS Foreign Exchange Limited
SUS	S & U Plc
SUSB	ETFS Foreign Exchange Li
SUSC	SSGA SPDR ETFS Europe I
SUSD	SSGA SPDR ETFS Europe I
SUSE	Ishares II Plc
SUSS	Ishares II Plc
SVCA	Servoca Plc
SVE	Starvest Plc
SVI	Svg Capital Plc
SVM	Svm UK Emerging Fund Plc
SVR	Servicepower Technologies Plc
SVS	Savills Plc
SVST	Oao Severstal
SVT	Severn Trent Plc
SVTL	Severn Trent Plc
SWALLE	FTSE Shariah Emerging Index
SWAP	Moneyswap Plc
SWCHN	FTSE Shariah China Index
SWDA	Ishares III Plc
SWDEURS	FTSE Shariah Developed Europe Index
SWDPAC	FTSE Shariah Developed Asia Pacific
SWDPACXJ	FTSE Shariah Developed Asia Pacific Ex J
SWDXUS	FTSE Shariah Developed Ex US Index
SWEA	ETFS Commodity Securities Limited
SWEF	Starwood European Real E
SWIND	FTSE Shariah India Index
SWL	Swallowfield Plc
SWORLDS	FTSE Shariah All-World Index
SWP	Swp Group Plc
SWPACXJA	FTSE Shariah Asia Pacific Ex Japan Index
SWPXJAN	FTSE Shariah Asia-Pacific
SWUSA	FTSE Shariah USA Index
SX5S	Source Markets Public Li
SXFN	Ishares II Plc
SXLB	SSGA SPDR ETFS Europe II
SXLE	SSGA SPDR ETFS Europe II
SXLF	SSGA SPDR ETFS Europe II
SXLI	SSGA SPDR ETFS Europe II
SXLK	SSGA SPDR ETFS Europe II
SXLP	SSGA SPDR ETFS Europe II
SXLU	SSGA SPDR ETFS Europe II
SXLV	SSGA SPDR ETFS Europe II
SXLY	SSGA SPDR ETFS Europe II
SXS	Spectris Plc
SXX	Sirius Minerals Plc
SYM	Symphony Environmental Technologies Plc
SYNT	Synthomer Plc
SYP3	ETFS Foreign Exchange Li
SYQ	Syqic Plc
SZ51	Sga Societe Generale Acc
SZ58	Sga Societe Generale Acc
SZ64	Sga Societe Generale Acc
SZIC	ETFS Commodity Securities Limited
T16	United Kingdom
T17	United Kingdom
T18	United Kingdom
T19	United Kingdom
T1X	FTSE Techmark Focus
T20	United Kingdom
T22	United Kingdom
T23	United Kingdom
T24	United Kingdom
T24I	United Kingdom
T25	United Kingdom
T27	United Kingdom
T29	United Kingdom
T2HI	United Kingdom
T2IL	United Kingdom
T30I	United Kingdom
T32	United Kingdom
T39	United Kingdom
T40	United Kingdom
T42	United Kingdom
T42A	United Kingdom
T44	United Kingdom
T45	United Kingdom
T46	United Kingdom
T47	United Kingdom
T49	United Kingdom
T4Q	United Kingdom
T52	United Kingdom
T58	United Kingdom
T62	United Kingdom
T68	United Kingdom
TA10	Sg Issuer
TACDXUSR	FTSE Developed All Cap E
TAIH	Taihua Plc
TAL	Ten Alps Plc
TALK	Talktalk Telecom Group Plc
TAN	Tanfield Group Plc
TAP	Taptica International Ltd
TASE	Ishares IV Plc
TAST	Tasty Plc
TASX	FTSE Techmark Allshare
TATE	Tate & Lyle Plc
TAU	Tau Capital Plc
TAVI	Tavistock Investments Pl
TBCB	Tbc Bank Joint Stock Com
TBGR	Tiso Blackstar Group Se
TCA	Terra Capital Plc
TCF	Terra Catalyst Fund
TCG	Thomas Cook Group Plc
TCM	Telit Communications Plc
TCN	Tricorn Group Plc
TCS	Tcs Group Holding Plc
TDE	Telefonica Sa
TE10	Test Stocks
TE18	Test Stocks
TECH	Techfinancials Inc
TED	Ted Baker Plc
TEEG	Telecom Egypt S.A.E.
TEF	Telford Homes Plc
TEK	Tekcapital Plc
TELG	Multi Units Luxembourg
TELW	Multi Units Luxembourg
TEM	Templeton Emerging Markets Investment TR
TEN	Tengri Resources
TEP	Telecom Plus Plc
TERN	Tern Plc
TET	Treatt Plc
TFG	Tetragon Financial Group Limited
TFIF	Twentyfour Income Fund L
TFQEACR	FTSE Emerging Markets Al
TFW	Thorpe [F.W.] Plc
TG17	United Kingdom
TG19	United Kingdom
TG21	United Kingdom
TG22	United Kingdom
TG44	United Kingdom
TG52	United Kingdom
TGBL	Tata Global Beverages Ld
THAL	Thalassa Holdings Limited
THR	Thor Mining Plc
THRG	Throgmorton Trust Plc
THRL	Target Healthcare REIT L
TIDE	Crimson Tide Plc
TIGT	Troy Income & Growth Trust Plc
TILS	Tiziana Life Sciences Pl
TINM	ETFS Commodity Securities Limited
TIPS	SSGA SPDR ETFS Europe I Plc
TIR	Tiger Resource Finance Plc
TJI	Tejoori Limited
TLA	Tla Worldwide Plc
TLI	Alternative Asset Opportunities Pcc Ltd
TLOU	Tlou Energy Limited
TLPR	Tullett Prebon Plc
TLW	Tullow Oil Plc
TLY	Totally Plc
TMKS	Oao Tmk
TMMG	The Mission Marketing Group Plc
TMPL	Temple Bar Investment Trust Plc
TMS1	FTSE Techmark Mediscienc
TMZ	Toumaz Ld
TND	Tandem Group Plc
TNI	Trinity Mirror Plc
TNOG	Multi Units Luxembourg
TNOW	Multi Units Luxembourg
TOC1	Sg Issuer
TOM	Tomco Energy Plc
TON	Titon Holdings Plc
TOOP	Toople Plc
TORO	Toro Limited
TOT	Total Produce Plc
TOWN	Town Centre Securities Plc
TPF	Taliesin Property Fund Limited
TPFZ	Taliesin Property Fund L
TPG	Tp Group Plc
TPHU	Amundi ETF
TPK	Travis Perkins Plc
TPL	Tethys Petroleum Limited
TPOG	Third Point Offshore Investors Limited
TPOP	People's Operator Plc (T
TPOU	Third Point Offshore Investors Limited
TPR1	Tullett Prebon Plc
TPS	Turbo Power Systems Inc
TPT	Topps Tiles Plc
TR16	United Kingdom
TR17	United Kingdom
TR18	United Kingdom
TR19	United Kingdom
TR1T	United Kingdom
TR20	United Kingdom
TR21	United Kingdom
TR22	United Kingdom
TR24	United Kingdom
TR25	United Kingdom
TR26	United Kingdom
TR27	United Kingdom
TR28	United Kingdom
TR30	United Kingdom
TR32	United Kingdom
TR34	United Kingdom
TR37	United Kingdom
TR38	United Kingdom
TR40	United Kingdom
TR46	United Kingdom
TR4Q	United Kingdom
TR50	United Kingdom
TR60	United Kingdom
TR68	United Kingdom
TR8F	United Kingdom
TRAF	Trafalgar New Homes Plc
TRAK	Trakm8 Holdings Plc
TRB	Tribal Group Plc
TRC	Trinity Capital Plc
TRCS	Tracsis Plc
TRD	Triad Group Plc
TRE	Trading Emissions Plc
TREE	Cambium Global Timberland Limited
TRG	TR European Growth Trust Plc
TRGOV01	
TRI	Trifast Plc
TRIC	Tricor Plc
TRIG	The Renewables Infrastru
TRIN	Trinity Exploration & Pr
TRIT	Trendit Ltd
TRK	Torotrak Plc
TRP	Tower Resources Plc
TRS	Tarsus Group Plc
TRS3	SSGA SPDR ETFS Europe I
TRSY	SSGA SPDR ETFS Europe I Plc
TRT	Transense Technologies Plc
TRTQ	United Kingdom
TRX	Tissue Regenix Group Plc
TRY	TR Property Investment Trust Plc
TS19	United Kingdom
TS1L	Tesco Personal Finance P
TS20	United Kingdom
TS52	Tesco Personal Finance P
TSC5	Tesco Personal Finance P
TSCO	Tesco Plc
TSG	Trans-Siberian Gold Plc
TSTL	Tristel Plc
TSTR	Tri-Star Resources Plc
TSY3	SSGA SPDR ETFS Europe I
TTA	Total S.A.
TTG	Tt Electronics Plc
TTR	32Red Plc
TTST	Tata Steel Limited
TUI	Tui Ag
TUNE	Focusrite Plc
TUNG	Tungsten Corporation Plc
TURL	Lyxor International Asse
TURU	Lyxor International Asse
TW	Taylor Wimpey
TW100	Tsec Taiwan Mid-Cap
TW50	FTSE Tsec Taiwan 50 Inde
TW50U	Tsec Taiwan 50 Index
TWDP	Tsec Taiwan Dividend
TWEI	Tsec Taiwan Eight Industries
TWSH	Tsec Taiwan Shariah Index
TWTECH	Tsec Taiwan Technology
TXH	Tex Holdings Plc
TY21	United Kingdom
TYM	Tertiary Minerals Plc
TYMN	Tyman Plc
TYR	Tyratech Inc
TYRU	Tyratech Inc
TYT	Toyota Motor Corporation
U10G	Multi Units France
UAI	U and I Group Plc
UANC	Urban&Civic Plc
UAV	Unicorn Aim Vct Plc
UB00	UBS ETF
UB01	UBS ETF
UB02	UBS ETF
UB03	UBS ETF
UB0500	FTSE 350 Supersector Oil
UB06	UBS ETF
UB12	UBS ETF
UB1300	FTSE 350 Supersector Che
UB17	UBS ETF
UB1700	FTSE 350 Supersector Bas
UB23	UBS ETF
UB2300	FTSE 350 Supersector Con
UB2700	FTSE 350 Supersector Ind
UB30	UBS ETF
UB32	UBS ETF
UB3300	FTSE 350 Supersector Aut
UB3500	FTSE 350 Supersector Foo
UB3700	FTSE 350 Supersector Per
UB39	UBS ETF
UB45	UBS ETF
UB4500	FTSE 350 Supersector Hea
UB5300	FTSE 350 Supersector Ret
UB5500	FTSE 350 Supersector Med
UB5700	FTSE 350 Supersector Tra
UB6500	FTSE 350 Supersector Tel
UB69	UBS ETF
UB74	UBS ETF
UB7500	FTSE 350 Supersector Uti
UB76	UBS ETF
UB82	UBS ETF
UB8300	FTSE 350 Supersector Ban
UB8500	FTSE 350 Supersector Ins
UB8600	FTSE 350 Supersector Rea
UB8700	FTSE 350 Supersector Fin
UB89	UBS ETF
UB91	UBS ETF
UB94	UBS ETF
UB9500	FTSE 350 Supersector Tec
UB96	UBS ETF
UB99	UBS ETF
UBI	Ubisense Group Plc
UBLS	United Bank Limited
UBM	Ubm Plc
UC04	UBS (Irl) ETF Plc
UC07	UBS (Irl) ETF Plc
UC10	UBS (Irl) ETF Plc
UC12	UBS (Irl) ETF Plc
UC13	UBS (Irl) ETF Plc
UC14	UBS ETFS Plc
UC15	UBS ETFS Plc
UC17	UBS ETFS Plc
UC22	UBS ETFS Plc
UC24	UBS ETFS Plc
UC30	UBS ETFS Plc
UC32	UBS ETFS Plc
UC35	UBS ETFS Plc
UC41	UBS ETFS Plc
UC42	UBS (Irl) ETF Plc
UC44	UBS ETF
UC46	UBS ETF
UC49	UBS (Irl) ETF Plc
UC51	UBS (Irl) ETF Plc
UC53	UBS (Irl) ETF Plc
UC55	UBS ETF
UC59	UBS ETF
UC60	UBS ETF
UC61	UBS ETF
UC62	UBS ETF
UC64	UBS ETF
UC65	UBS ETF
UC67	UBS ETF
UC68	UBS ETF
UC73	UBS (Irl) ETF Plc
UC74	UBS (Irl) ETF Plc
UC75	UBS (Irl) ETF Plc
UC76	UBS ETF
UC77	UBS ETF
UC78	UBS ETF
UC79	UBS ETF
UC81	UBS ETF
UC82	UBS ETF
UC85	UBS ETF
UC86	UBS ETF
UC89	UBS ETF
UC90	UBS ETFS Plc
UC93	UBS ETF
UC94	UBS ETF
UC97	UBS ETF
UCAP	Ossiam Lux
UCG	United Carpets Group Plc
UDG	United Drug Plc
UDVD	SSGA SPDR ETFS Europe I Plc
UEM	Utilico Emerging Markets Limited
UEMS	Utilico Emerging Markets Limited
UEN	Urals Energy Public Company Limited
UGAS	ETFS Commodity Securities Limited
UGNA	Epra/Nareit North America Index [Usd]
UI18	Ishares IV Plc
UIFS	Ishares V Public Limited Company
UINC	First Trust Global Funds Public Limited
UJO	Union Jack Oil Plc
UK19	Goldman Sachs Internatio
UK3L	ETFS Equity Securities L
UK3S	ETFS Equity Securities L
UKA5	Sg Issuer
UKCM	UK Commercial Property Trust Ld
UKCO	SSGA SPDR ETFS Europe I Plc
UKDIGEQ	FTSE UK Digital Services
UKDV	SSGA SPDR ETFS Europe I Plc
UKL3	Sg Issuer
UKLCEQSN	FTSE UK Large Cap Equall
UKM	UK Mail Group Plc
UKMD	Ossiam Lux
UKML	UK Mortgages Limited
UKMV	Ossiam Lux
UKOG	UK Oil & Gas Investments
UKR	Ukrproduct Group Limited
UKRE	Ishares III Plc
UKS3	Sg Issuer
UKSR	UBS (Irl) ETF Plc
UKT	UK Select Trust Ld
UKW	Greencoat UK Wind Plc
UKX	FTSE 100
UKXDUK	FTSE 100 Total Return Declared Dividend
UKXEQ	FTSE 100 Equally Index
UKXI1X	FTSE 100 Daily Short Str
UKXI2	FTSE 100 Daily Super Sho
UKXI2X	FTSE 100 Daily Super Sho
UKXI3X	FTSE 100 Daily Ultra Sho
UKXI5X	FTSE 100 Gross TR Index
UKXL2	FTSE 100 Daily Leveraged
UKXL2X	FTSE 100 Daily Leveraged
UKXL3X	FTSE 100 Daily Super Lev
UKXL4X	FTSE 100 Daily Ultra Lev
UKXL5X	FTSE 100 TR Index
UKXM	FTSE 100 Mini Index
UKXMV	FTSE 100 Minimum Variance Index
UKXNUK	FTSE 100 Net Dividend Index
UKXS	FTSE 100 Daily Short Ind
UKXSP	FTSE 100 Expiry Index
UKXUSD	FTSE 100 - USD Index
UKXUSDM	FTSE 100 USD Mini Index
ULE	Ultra Electronics Holdings Plc
ULS	Uls Technology Plc
ULVR	Unilever Plc
UNG	Universe Group Plc
UNGL	Epra/Nareit Global Index [Usd]
UNUS	Epra United States Index
UPL	Upland Resources Limited
UPRA	Epra Europe Index [Usd]
URA	Uranium Resources Plc
URGB	ETFS Foreign Exchange Limited
URU	Uru Metals Limited
US10	Multi Units France
US13	Multi Units France
US500	FTSE US 500 Index
US57	Multi Units France
USAG	SSGA SPDR ETFS Europe I Plc
USAL	Lyxor International Asse
USAU	Lyxor International Asse
USCSLL2X	FTSE USA Small Cap Super Liquid 2X Daily
USCSLL3X	FTSE USA Small Cap Super Liquid 3X Daily
USCSLS1X	FTSE USA Small Cap Super Liquid Daily Sh
USCSLS2X	FTSE USA Small Cap Super Liquid 2X Daily
USCSLS3X	FTSE USA Small Cap Super Liquid 3X Daily
USD2	ETFS Foreign Exchange Li
USDV	SSGA SPDR ETFS Europe I Plc
USEF	Fundlogic Alternatives P
USG	Ultimate Sports Group Plc
USGB	ETFS Foreign Exchange Limited
USIG	Lyxor Index Fund
USIX	Lyxor Index Fund
USLV	SSGA SPDR ETFS Europe I
USMV	Ossiam Lux
USP3	ETFS Foreign Exchange Li
USP5	ETFS Foreign Exchange Limited
USPR	Ishares III Plc
USPY	Go Ucits ETF Solutions Plc
USRE	Ishares III Plc
USSC	SSGA SPDR ETFS Europe II
UST	Lyxor International Asse
USTL	Lyxor International Asse
USTY	SSGA SPDR ETFS Europe I
USVL	SSGA SPDR ETFS Europe II
UTG	Unite Group Plc
UTG1	Unite Group Plc
UTIG	Multi Units Luxembourg
UTIL	SSGA SPDR ETFS Europe II
UTIP	SSGA SPDR ETFS Europe I Plc
UTIW	Multi Units Luxembourg
UTL	Utilico Investments Limited
UTLC	Utilico Finance Limited
UTLD	Utilico Finance Limited
UTLE	Utilico Finance Limited
UTW	Utilitywise Plc
UU	United Utilities
UVEL	Univision Engineering Limited
VAL	Valirx Plc
VAPX	Vanguard Funds Plc
VAST	Vast Resources Plc
VCBC	Vertu Capital Limited
VCP	Victoria Plc
VCT	Victrex Plc
VDCP	Vanguard Funds Plc
VDEM	Vanguard Funds Plc
VDEV	Vanguard Funds Plc
VDJP	Vanguard Funds Plc
VDLQ	Vanguard Funds Plc
VDMO	Vanguard Funds Plc
VDMV	Vanguard Funds Plc
VDNR	Vanguard Funds Plc
VDPX	Vanguard Funds Plc
VDTY	Vanguard Funds Plc
VDVA	Vanguard Funds Plc
VEC	Vectura Group Plc
VECP	Vanguard Funds Plc
VED	Vedanta Resources Plc
VELA	Vela Technologies Plc
VEN	Ventus Vct Plc
VEN2	Ventus 2 Vct Plc
VENC	Ventus Vct Plc
VENN	Venn Life Sciences Holdi
VER	Vernalis Plc
VERX	Vanguard Funds Plc
VETY	Vanguard Funds Plc
VEUD	Vanguard Funds Plc
VEUR	Vanguard Funds Plc
VEVE	Vanguard Funds Plc
VFEM	Vanguard Funds Plc
VGAS	Volga Gas Plc
VGOV	Vanguard Funds Plc
VHYD	Vanguard Funds Plc
VHYL	Vanguard Funds Plc
VICO	Vimetco N.V.
VIN	Value and Income Trust Plc
VIP	Vipera Plc
VIS	Vitesse Media Plc
VJPN	Vanguard Funds Plc
VLE	Volvere Plc
VLG	Venture Life Group Plc
VLIQ	Vanguard Funds Plc
VLK	Vislink Plc
VLS	Velocys Plc
VLX	Volex Plc
VM	Virgin Money Holdings
VMID	Vanguard Funds Plc
VMOM	Vanguard Funds Plc
VMVL	Vanguard Funds Plc
VNC	Ventus 2 Vct Plc
VNET	Vianet Group Plc
VNH	Vietnam Holding Limited
VNHW	Vietnam Holding Limited
VNI	Vietnam Infrastructure Limited
VNIL	Vietnam Infrastructure L
VNL	Vinaland Limited
VNLZ	Vinaland Zdp Ltd
VNRT	Vanguard Funds Plc
VO25	Vodafone Group Plc
VO32	Vodafone Group Plc
VOD	Vodafone Group Plc
VOF	Vinacapital Vietnam Opportunity Fund Ld
VOG	Victoria Oil & Gas Plc
VP	VP Plc
VRP	Verona Pharma Plc
VRS	Versarien Plc
VSL	Vpc Specialty Lending In
VSN	Verseon Corporation Plc
VSVS	Vesuvius Plc
VSXG	Barclays Bank Plc
VSXX	Barclays Bank Plc
VSXY	Barclays Bank Plc
VSYG	Barclays Bank Plc
VTA	Volta Finance Limited
VTBR	Jsc Vtb Bank
VTC	Vitec Group Plc [The]
VTU	Vertu Motors Plc
VUCP	Vanguard Funds Plc
VUKE	Vanguard Funds Plc
VUSA	Vanguard Funds Plc
VUSD	Vanguard Funds Plc
VUTY	Vanguard Funds Plc
VVAL	Vanguard Funds Plc
VWRD	Vanguard Funds Plc
VWRL	Vanguard Funds Plc
VXIM	Barclays Bank Plc
VXIS	Barclays Bank Plc
WAFM	West African Minerals Corporation
WAND	Wandisco Plc
WAS1	Wasps Finance Plc
WATL	Lyxor International Asse
WATR	Water Intelligence Plc
WBS	West Bromwich Building Society
WCOA	Wisdomtree Issuer Plc
WCOB	Wisdomtree Issuer Plc
WCOD	SSGA SPDR ETFS Europe II Plc
WCOG	Wisdomtree Issuer Plc
WCOS	SSGA SPDR ETFS Europe II Plc
WCW	Walker Crips Group Plc
WDMV	Ossiam Lux
WDSC	SSGA SPDR ETFS Europe II
WEAT	ETFS Commodity Securities Limited
WEB	Webis Holdings Plc
WEIR	Weir Group Plc
WEY	Wey Education Plc
WG	Wood Group (John)
WGB	Walker Greenbank Plc
WHI	W.H. Ireland Group Plc
WHTU	UBS Ag
WI01	FTSE World
WI02	FTSE World Ex South Afri
WI03	FTSE World Europe Ex EUR
WIAUS	FTSE Australia Index
WIAUT	FTSE Austria Index
WIBEL	FTSE Belgium/Lux Index
WIBRA	FTSE Brazil Index
WICAN	FTSE Canada Index
WICHE	FTSE Switzerland Index
WICHL	FTSE Chile Index
WICHN	FTSE China Index
WICOL	FTSE Colombia Index
WICZH	FTSE Czech Rep. Index
WIDEN	FTSE Denmark Index
WIDEU	FTSE Germany Index
WIEGY	FTSE Egypt Index
WIESP	FTSE Spain Index
WIFIN	FTSE Finland Index
WIFRA	FTSE France Index
WIGBR	FTSE UK Index
WIGRC	FTSE Greece Index
WIHKG	FTSE Hong Kong Index
WIHUN	FTSE Hungary Index
WIIDN	FTSE Indonesia Index
WIIND	FTSE India Index
WIIRL	FTSE Ireland Index
WIISR	FTSE Israel Index
WIITA	FTSE Italy Index
WIJPNC	FTSE Japan Index
WIJPNE	FTSE Japan Index  EUR
WIJPNG	FTSE Japan Index - Gbp
WIJPNL2X	FTSE Japan 2X Daily Leveraged Index
WIJPNL3X	FTSE Japan 3X Daily Leveraged Index
WIJPNS1X	FTSE Japan Daily Short Index
WIJPNS2X	FTSE Japan 2X Daily Short Index
WIJPNS3X	FTSE Japan 3X Daily Short Index
WIJPNU	FTSE Japan Index - USD
WIJPUMVN	FTSE Japan Minimum Varia
WIKOR	FTSE Korea Index
WIL	Wilmington Group Plc
WIMAL	FTSE Malaysia Index
WIMEX	FTSE Mexico Index
WIN	Wincanton Plc
WINE	Majestic Wine Plc
WINK	M Winkworth Plc
WINLD	FTSE Netherlands Index
WINOR	FTSE Norway Index
WINZL	FTSE New Zealand Index
WIPAK	FTSE Pakistan Index
WIPER	FTSE Peru Index
WIPHL	FTSE Philippines Index
WIPOL	FTSE Poland Index
WIPTL	FTSE Portugal Index
WIRUS	FTSE Russia Index
WISGP	FTSE Singapore Index
WISWE	FTSE Sweden Index
WITHA	FTSE Thailand Index
WITUR	FTSE Turkey Index
WITWN	FTSE Taiwan Index
WIUAE	FTSE UAE Index
WIUSA	FTSE USA Index
WIUSAMVN	FTSE USA Minimum Varianc
WIZAF	FTSE South Africa Index
WIZZ	Wizz Air Holdings Plc
WJG	Watkin Jones Plc
WKOF	Weiss Korea Opportunity
WKP	Workspace Group Plc
WKP1	Workspace Group Plc
WLDD	Lyxor International Asse
WLDL	Lyxor International Asse
WLDU	Lyxor International Asse
WLFE	Wolf Minerals Limited
WLG	Wireless Group Plc
WMH	William Hill Plc
WOOD	Ishares II Plc
WOR	World Careers Network Plc
WORK	Work Group Plc
WOS	Wolseley Plc
WOSC	SSGA SPDR ETFS Europe II
WPC	Witan Pacific Investment Trust Plc
WPCT	Woodford Patient Capital
WPG	Worldpay Group Plc
WPHO	Windar Photonics Plc
WPP	Wpp Plc
WRES	W Resources Plc
WRL	Wentworth Resources Limited
WSBN	Wishbone Gold Plc
WSG	Westminster Group Plc
WSP	Wynnstay Properties Plc
WTAN	Witan Investment Trust Plc
WTB	Whitbread Plc
WTE	Westmount Energy Limited
WTEC	SSGA SPDR ETFS Europe II Plc
WTG	Watchstone Group Plc
WTI	Weatherly International Plc
WTID	Boost Issuer Public Limi
WTM	Waterman Group Plc
WTR	World Trust Fund
WUKD	Wisdomtree Issuer Plc
WUTI	SSGA SPDR ETFS Europe II Plc
WWH	Worldwide Healthcare Trust Plc
WYG	Wyg Plc
WYN	Wynnstay Group Plc
X7PP	Source Markets Public Li
X7PS	Source Markets Public Li
XAHG	DB X-Trackers Dbx MSCI AC Asia
XAR	Xaar Plc
XASX	DB X-Trackers Dbx FTSE All-Shar
XAUS	DB X-Trackers Dbx S&P/Asx 200 E
XAXD	DB X-Trackers Dbx MSCI AC Asia
XAXJ	DB X-Trackers Dbx MSCI AC Asia
XBAG	DB X-Trackers II
XBAK	DB X-Trackers Dbx MSCI Pakistan
XBAN	DB X-Trackers Dbx MSCI Banglade
XBCU	DB X-Trackers Dbx Dblci - Oy BA
XBGG	DB X-Trackers II
XBUI	DB X-Trackers II Dbx Iboxx UK G
XBUT	DB X-Trackers II Dbx Iboxx Gbp
XCAD	DB X-Trackers Dbx MSCI Canada E
XCH	Xchanging Plc
XCHA	DB X-Trackers Dbx Csi300 ETF
XCS3	DB X-Trackers
XCS4	DB X-Trackers
XCS5	DB X-Trackers
XCS6	DB X-Trackers
XCT9	DB Etc Index Plc
XCX3	DB X-Trackers
XCX4	DB X-Trackers
XCX5	DB X-Trackers
XCX6	DB X-Trackers
XD3E	DB X-Trackers
XD5D	DB X-Trackers
XD5E	DB X-Trackers
XD5F	DB X-Trackers
XD5S	DB X-Trackers
XD9U	Concept Fund Solutions P
XDBG	DB X-Trackers Dbx Dblci - Oy BA
XDDX	DB X-Trackers DB X-Trackers DAX
XDEB	Concept Fund Solutions P
XDEQ	Concept Fund Solutions P
XDER	DB X-Trackers Dbx FTSE Epra/Nar
XDEV	Concept Fund Solutions P
XDEW	Concept Fund Solutions P
XDEX	Concept Fund Solutions P
XDGM	Concept Fund Solutions P
XDGU	Concept Fund Solutions Plc
XDJP	DB X-Trackers Dbxt Nikkei 225 D
XDN0	Concept Fund Solutions P
XDND	Concept Fund Solutions P
XDNG	Concept Fund Solutions P
XDNS	Concept Fund Solutions P
XDNU	Concept Fund Solutions P
XDNY	Concept Fund Solutions P
XDPG	Concept Fund Solutions P
XDTK	Concept Fund Solutions P
XDUK	DB X-Trackers Dbxt Ftse100 [Dir
XDUS	Concept Fund Solutions P
XDW0	Concept Fund Solutions Plc
XDWC	Concept Fund Solutions Plc
XDWD	Concept Fund Solutions P
XDWE	Concept Fund Solutions P
XDWF	Concept Fund Solutions Plc
XDWH	Concept Fund Solutions Plc
XDWI	Concept Fund Solutions Plc
XDWM	Concept Fund Solutions Plc
XDWS	Concept Fund Solutions Plc
XDWT	Concept Fund Solutions Plc
XDWU	Concept Fund Solutions Plc
XECS	DB X-Trackers Dbx MSCI EM Consu
XEL	Xcite Energy Limited
XEMD	DB X-Trackers Dbx MSCI Emerging
XEMM	DB X-Trackers Dbx MSCI Emerging
XEOU	DB X-Trackers
XESC	DB X-Trackers Dbx Euro Stoxx 50
XESG	DB X-Trackers Dbx MSCI Emerging
XESX	DB X-Trackers Dbx Euro Stoxx 50
XEUM	DB X-Trackers Dbx MSCI Europe M
XEUT	DB X-Trackers Dbx MSCI Emerging
XFEW	Concept Fund Solutions P
XFNS	Source Markets Public Limited Company
XFRM	ETFS Commodity Securitie
XFVT	DB X-Trackers Dbx FTSE Vietnam
XG5D	DB X-Trackers II
XG7C	DB X-Trackers II
XG7S	DB X-Trackers II
XG7U	DB X-Trackers II
XGDD	DB X-Trackers Dbx Stoxx Global
XGID	DB X-Trackers Dbx S&P Gbl Infra
XGIG	DB X-Trackers II Dbx Global Inf
XGIU	DB X-Trackers II
XGLD	DB Etc Plc
XGLE	DB X-Trackers II Dbx Iboxx EUR
XGLF	Concept Fund Solutions P
XGLR	DB X-Trackers Dbx DB FTSE Epra/
XGLS	DB Etc Plc
XGSD	DB X-Trackers Dbx Stoxx Global
XGSG	DB X-Trackers II Dbx Global Sov
XHFD	DB X-Trackers Dbx DB Hedge Fund
XHFG	DB X-Trackers Dbx DB Hedge Fund
XHSD	DB X-Trackers Dbx Hsi Short Dai
XICL	Ftse/Xinhua Insurance Invest Idx
XIDD	DB X-Trackers Dbx MSCI Indonesi
XIMT	DB X-Trackers Dbx Islamic Marke
XIN0	FTSE Xinhua China 25
XIN0CN	FTSE China 50 Net Tax CA
XIN0N	FTSE Xinhua China 50
XIN0U	Ftse/Xinhua China 25 Ind
XIN0UL2X	FTSE China 50 2X Daily Leveraged Index
XIN0UL3X	FTSE China 50 3X Daily Leveraged Index
XIN0UN	FTSE Xinhua China 50
XIN0US1X	FTSE China 50 2X Daily Short Index
XIN0US2X	FTSE China 50 Daily Short Index
XIN0US3X	FTSE China 50 3X Daily Short Index
XIN1	FTSE Xinhua B 35 Index
XIN2	FTSE Xinhua B All-Share
XIN3	FTSE Xinhua A 200 Index
XIN4	FTSE Xinhua A 600 Index
XIN40001	FTSE Xin600 Oil & Gas
XIN40530	FTSE Xin600 Oil & Gas Pr
XIN40570	FTSE Xin600 Oil Equip. S
XIN40580	FTSE Xinhua A600 Index A
XIN41000	FTSE Xin600 Basic Materi
XIN41350	FTSE Xin600 Chemicals
XIN41750	FTSE Xin600 Industrial M
XIN41770	FTSE Xin600 Mining
XIN42000	FTSE Xin600 Industrials
XIN42350	FTSE Xin600 Construction
XIN42710	FTSE Xin600 Aerospace &
XIN42720	FTSE Xin600 General Indu
XIN42730	FTSE Xin600 Electronic&E
XIN42750	FTSE Xin600 Industrial E
XIN42770	FTSE Xin600 Industrial T
XIN42790	FTSE Xin600 Support Serv
XIN43000	FTSE Xin600 Consumer Goo
XIN43350	FTSE Xin600 Automobiles
XIN43530	FTSE Xin600 Beverages
XIN43570	FTSE Xin600 Food Produce
XIN43720	FTSE Xin600 Household Go
XIN43740	FTSE Xin600 Leisure Good
XIN43760	FTSE Xin600 Personal Goo
XIN44000	FTSE Xin600 Health Care
XIN44570	FTSE Xin600 Pharmaceutic
XIN45000	FTSE Xin600 Consumer Ser
XIN45330	FTSE Xin600 Food & Drug
XIN45370	FTSE Xin600 General Reta
XIN45550	FTSE Xin600 Media
XIN45750	FTSE Xin600 Travel & Lei
XIN46000	FTSE Xin600 Telecommunic
XIN46570	FTSE Xin600 Mobile Telec
XIN47000	FTSE Xin600 Utilities
XIN47530	FTSE Xin600 Electricity
XIN47570	FTSE Xin600 Gas Water &
XIN48000	FTSE Xin600 Financials
XIN48350	FTSE Xin600 Banks
XIN48570	FTSE Xin600 Life Insuran
XIN48630	FTSE Xinhua A600 Index R
XIN48770	FTSE Xin600 General Fina
XIN49000	FTSE Xin600 Technology
XIN49530	FTSE Xin600 Software & C
XIN49570	FTSE Xin600 Technology H
XIN5	FTSE Xinhua A 400 Index
XIN6	FTSE Xinhua A Smallcap
XIN7	FTSE Xinhua A All-Share
XIN9	FTSE China A50 Index
XINA50N	FTSE China A50 Net Index
XINBV	Ftse/Xinhua Blueship Value 100 Idx
XINC	FTSE Xinhua China Index
XINH	Ftse/Xinhua H Share Index
XKS2	DB X-Trackers
XKSD	DB X-Trackers Dbx MSCI Korea Et
XLBP	Source Markets Public Li
XLBS	Source Markets Public Limited Company
XLDX	DB X-Trackers Dbx Levdax Daily
XLEP	Source Markets Public Li
XLES	Source Markets Public Limited Company
XLFQ	Source Markets Public Li
XLFS	Source Markets Public Limited Company
XLIP	Source Markets Public Li
XLIS	Source Markets Public Limited Company
XLKQ	Source Markets Public Li
XLKS	Source Markets Public Limited Company
XLM	Xlmedia Plc
XLPE	DB X-Trackers Dbx Lpx Mm Privat
XLPP	Source Markets Public Li
XLPS	Source Markets Public Limited Company
XLUP	Source Markets Public Li
XLUS	Source Markets Public Limited Company
XLVP	Source Markets Public Li
XLVS	Source Markets Public Limited Company
XLYP	Source Markets Public Li
XLYS	Source Markets Public Limited Company
XMAD	DB X-Trackers Dbx MSCI Emerging
XMAF	DB X-Trackers Dbx MSCI Efm Afri
XMAS	DB X-Trackers Dbx MSCI Emerging
XMAW	Concept Fund Solutions P
XMBD	DB X-Trackers Dbx MSCI Brazil E
XMBR	DB X-Trackers Dbx MSCI Brazil E
XMCX	DB X-Trackers Dbx FTSE 250 ETF
XMED	DB X-Trackers Dbx MSCI Europe E
XMEE	DB X-Trackers Dbx MSCI EM Easte
XMEH	DB X-Trackers Dbx MSCI Emerging
XMEI	DB X-Trackers Dbx MSCI Emerging
XMEM	DB X-Trackers Dbx MSCI Emerging
XMES	DB X-Trackers Dbx MSCI Mexico E
XMET	DB X-Trackers Dbx MSCI EM Infor
XMEU	DB X-Trackers Dbx MSCI Europe E
XMEX	DB X-Trackers Dbx MSCI Mexico E
XMEY	DB X-Trackers Dbx MSCI EM Energ
XMID	DB X-Trackers Dbx MSCI Indonesi
XMJD	DB X-Trackers Dbx MSCI Japan Et
XMJG	DB X-Trackers Dbx MSCI Japan Et
XMJP	DB X-Trackers Dbx MSCI Japan Et
XMLA	DB X-Trackers Dbx MSCI EM Latam
XMLD	DB X-Trackers Dbx MSCI EM Latam
XMMD	DB X-Trackers Dbx MSCI Emerging
XMRC	DB X-Trackers Dbx MSCI Russia 2
XMRD	DB X-Trackers Dbx MSCI Russia 2
XMTD	DB X-Trackers Dbx MSCI Taiwan E
XMTW	DB X-Trackers Dbx MSCI Taiwan E
XMUD	DB X-Trackers Dbx MSCI USA ETF
XMUJ	DB X-Trackers Dbxt MSCI Japan T
XMUS	DB X-Trackers Dbx MSCI USA ETF
XMWD	DB X-Trackers Dbx MSCI World Et
XMXD	DB X-Trackers Dbx MSCI Emerging
XNID	DB X-Trackers Dbx CNX Nifty Uci
XNIF	DB X-Trackers Dbx CNX Nifty Uci
XPAL	DB Etc Plc
XPHG	DB X-Trackers Dbx MSCI Philippi
XPHI	DB X-Trackers Dbx MSCI Philippi
XPLA	DB Etc Plc
XPP	Xp Power Limited
XPXD	DB X-Trackers Dbx MSCI Pacific
XPXJ	DB X-Trackers Dbx MSCI Pacific
XQUA	Concept Fund Solutions Plc
XRES	Source Markets Public Limited Company
XRH0	DB Etc Plc
XRMU	Concept Fund Solutions P
XRSG	Concept Fund Solutions P
XRSS	Concept Fund Solutions P
XRSU	Concept Fund Solutions P
XS2D	DB X-Trackers
XS3R	DB X-Trackers
XS6R	DB X-Trackers
XS7R	DB X-Trackers
XS7S	DB X-Trackers
XS8R	DB X-Trackers
XSD2	DB X-Trackers
XSDR	DB X-Trackers Dbx Stoxx Europe
XSDX	DB X-Trackers Dbx Shortdax Dail
XSER	DB X-Trackers Dbx Stoxx Europe
XSFD	DB X-Trackers Dbx S&P Select Fr
XSFR	DB X-Trackers Dbx S&P Select Fr
XSG	Xeros Technology Group P
XSGI	DB X-Trackers Dbx S&P Global In
XSIL	DB Etc Plc
XSIR	DB X-Trackers Dbx Stoxx Europe
XSKR	DB X-Trackers Dbx Stoxx Europe
XSNR	DB X-Trackers Dbx Stoxx Europe
XSPD	DB X-Trackers Dbx S&P 500 Inver
XSPR	DB X-Trackers Dbx Stoxx Europe
XSPS	DB X-Trackers Dbx S&P 500 Inver
XSPU	DB X-Trackers Dbx S&P 500 ETF $
XSPX	DB X-Trackers Dbx S&P 500 ETF
XSSX	DB X-Trackers Dbx Euro Stoxx 50
XSTR	DB X-Trackers II Dbx Sterling C
XSX6	DB X-Trackers
XT2D	DB X-Trackers
XTR	Xtract Energy Plc
XUGS	DB X-Trackers II Dbx UK Gilts S
XUIT	DB X-Trackers II Dbx USD Ig Inf
XUKS	DB X-Trackers Dbx FTSE 100 Shor
XUKX	DB X-Trackers Dbx FTSE 100 ETF
XUSD	DB X-Trackers Dbx US Dollar Cas
XUT3	DB X-Trackers II
XUTD	DB X-Trackers II Dbx Iboxx USD
XUTS	DB X-Trackers II Dbx US Treasur
XVTD	DB X-Trackers Dbx FTSE Vietnam
XWLD	Concept Fund Solutions P
XWMD	DB X-Trackers Dbx MSCI World Ma
XWTD	DB X-Trackers
XWTS	Concept Fund Solutions Plc
XWUT	DB X-Trackers DB X-Trackers Msc
XX25	DB X-Trackers
XX2D	DB X-Trackers
XXSC	DB X-Trackers MSCI Europe Small
YIEL	Multi Units France
YNGA	Young & Co's Brewery Plc [Aim]
YNGN	Young & Co's Brewery Plc [Aim]
YOLO	Yolo Leisure and Technol
YOU	Yougov Plc
ZAM	Zambeef Products Plc
ZBO	Zibao Metals Recycling H
ZC1G	BMO Ucits ETF Icav
ZC3G	BMO Ucits ETF Icav
ZC7G	BMO Ucits ETF Icav
ZENB	Zenith Bank Plc
ZINC	ETFS Commodity Securities Limited
ZIOC	Zanaga Iron Ore Company Limited
ZMNO	Zamano Plc
ZOL	Zoltav Resources Inc
ZOO	Zoo Digital Group Plc
ZOX	Zincox Resources Plc
ZPLA	Zoopla Property Group Pl
ZTF	Zotefoams Plc
ZYT	Zytronic Plc
ZZZ	Snoozebox Holdings Plc
